AAAAAAGACTCCCGAACTCT -> AAAAAGACTCCCGAACTCTG
AAAAAGACTCCCGAACTCTG -> AAAAGACTCCCGAACTCTGG
AAAAGACTCCCGAACTCTGG -> AAAGACTCCCGAACTCTGGT
AAAAGATAGCTTCGAGTCGA -> AAAGATAGCTTCGAGTCGAG
AAAAGGGGAGGCCAGTCTGA -> AAAGGGGAGGCCAGTCTGAA
AAACAATTCGTCAACTATGT -> AACAATTCGTCAACTATGTA
AAACACGGGGCTGAAGCTTG -> AACACGGGGCTGAAGCTTGG
AAACAGGAGGATTGGGTTAT -> AACAGGAGGATTGGGTTATT
AAACGCAGGACCTATGTCAT -> AACGCAGGACCTATGTCATG
AAACTACCTAAGTGCTTTGG -> AACTACCTAAGTGCTTTGGG
AAAGACCCTTCGTAAAGTCG -> AAGACCCTTCGTAAAGTCGC
AAAGACTCCCGAACTCTGGT -> AAGACTCCCGAACTCTGGTG
AAAGATAGCTTCGAGTCGAG -> AAGATAGCTTCGAGTCGAGG
AAAGGGGAGGCCAGTCTGAA -> AAGGGGAGGCCAGTCTGAAA
AAAGTCCGTTAAGCTGGCAA -> AAGTCCGTTAAGCTGGCAAG
AAAGTCGCTACCTTACTGGT -> AAGTCGCTACCTTACTGGTA
AAATACACCTCGCCTTTGTA -> AATACACCTCGCCTTTGTAA
AAATAGGACCCGATCTAGAC -> AATAGGACCCGATCTAGACG
AAATCCGTATATGACCTATC -> AATCCGTATATGACCTATCA
AAATCTTAGCAGACTATCAC -> AATCTTAGCAGACTATCACG
AACAAGGCGGTGCTATTTGG -> ACAAGGCGGTGCTATTTGGC
AACAATTCGTCAACTATGTA -> ACAATTCGTCAACTATGTAA
AACACGGGGCTGAAGCTTGG -> ACACGGGGCTGAAGCTTGGT
AACAGACCCGACTATGGCCA -> ACAGACCCGACTATGGCCAC
AACAGGAGGATTGGGTTATT -> ACAGGAGGATTGGGTTATTA
AACCTTCTCAACAAGGCGGT -> ACCTTCTCAACAAGGCGGTG
AACGCAGGACCTATGTCATG -> ACGCAGGACCTATGTCATGC
AACTACCTAAGTGCTTTGGG -> ACTACCTAAGTGCTTTGGGC
AACTATGTAAGTGGCGTCGC -> ACTATGTAAGTGGCGTCGCC
AACTCTGGTGTTACCCATCC -> ACTCTGGTGTTACCCATCCC
AACTTCAAGCCGGCCTCTGG -> ACTTCAAGCCGGCCTCTGGG
AACTTTCCCTCGACGACAAC -> ACTTTCCCTCGACGACAACA
AAGAATAAGACGGTGAATGA -> AGAATAAGACGGTGAATGAC
AAGACCCTTCGTAAAGTCGC -> AGACCCTTCGTAAAGTCGCT
AAGACGGTGAATGACTAAAC -> AGACGGTGAATGACTAAACA
AAGACTCCCGAACTCTGGTG -> AGACTCCCGAACTCTGGTGT
AAGAGCGACATCACGGGTAG -> AGAGCGACATCACGGGTAGG
AAGAGTGCCAGGTTGATAAC -> AGAGTGCCAGGTTGATAACC
AAGATAGCTTCGAGTCGAGG -> AGATAGCTTCGAGTCGAGGT
AAGATCACTTGCATATCCTT -> AGATCACTTGCATATCCTTT
AAGCAGGTGGCCGCGATCAA -> AGCAGGTGGCCGCGATCAAG
AAGCATTACAGGAGAAGCCT -> AGCATTACAGGAGAAGCCTA
AAGCCGGCCTCTGGGGGTGC -> AGCCGGCCTCTGGGGGTGCG
AAGCCTATCATGGTCGCTTT -> AGCCTATCATGGTCGCTTTG
AAGCTCACAAGAGCGACATC -> AGCTCACAAGAGCGACATCA
AAGCTGGCAAGCAGGTGGCC -> AGCTGGCAAGCAGGTGGCCG
AAGCTTGGTGTTTTCATTGG -> AGCTTGGTGTTTTCATTGGA
AAGGACGGGAAGTTATCAGA -> AGGACGGGAAGTTATCAGAC
AAGGCGGTGCTATTTGGCCG -> AGGCGGTGCTATTTGGCCGG
AAGGGGAGGCCAGTCTGAAA -> AGGGGAGGCCAGTCTGAAAT
AAGGGGGGATTGCCCAGTAT -> AGGGGGGATTGCCCAGTATG
AAGTATACCCAAGGACGGGA -> AGTATACCCAAGGACGGGAA
AAGTCCGTTAAGCTGGCAAG -> AGTCCGTTAAGCTGGCAAGC
AAGTCGCTACCTTACTGGTA -> AGTCGCTACCTTACTGGTAA
AAGTGCTTTGGGCGATAGAG -> AGTGCTTTGGGCGATAGAGT
AAGTGGCGTCGCCCATGGTT -> AGTGGCGTCGCCCATGGTTG
AAGTTATCAGACAGGTCTTG -> AGTTATCAGACAGGTCTTGA
AATAAGACGGTGAATGACTA -> ATAAGACGGTGAATGACTAA
AATACACCTCGCCTTTGTAA -> ATACACCTCGCCTTTGTAAG
AATAGGACCCGATCTAGACG -> ATAGGACCCGATCTAGACGT
AATAGGAGGATAGGTGGATA -> ATAGGAGGATAGGTGGATAC
AATCCGTATATGACCTATCA -> ATCCGTATATGACCTATCAC
AATCTCAATAGGAGGATAGG -> ATCTCAATAGGAGGATAGGT
AATCTGGAAACAATTCGTCA -> ATCTGGAAACAATTCGTCAA
AATCTTAGCAGACTATCACG -> ATCTTAGCAGACTATCACGA
AATGACTAAACACGGGGCTG -> ATGACTAAACACGGGGCTGA
AATGGTAAACAGGAGGATTG -> ATGGTAAACAGGAGGATTGG
AATTCGATAGTGCCAGATTG -> ATTCGATAGTGCCAGATTGA
AATTCGTCAACTATGTAAGT -> ATTCGTCAACTATGTAAGTG
ACAACAGACCCGACTATGGC -> CAACAGACCCGACTATGGCC
ACAAGAGCGACATCACGGGT -> CAAGAGCGACATCACGGGTA
ACAAGGCGGTGCTATTTGGC -> CAAGGCGGTGCTATTTGGCC
ACAATTCGTCAACTATGTAA -> CAATTCGTCAACTATGTAAG
ACACCGGCTTGGGCCCTATA -> CACCGGCTTGGGCCCTATAC
ACACCTCGCCTTTGTAAGAG -> CACCTCGCCTTTGTAAGAGT
ACACGAGCTGGGGCCAATCT -> CACGAGCTGGGGCCAATCTC
ACACGGGGCTGAAGCTTGGT -> CACGGGGCTGAAGCTTGGTG
ACACTGAAAAGATAGCTTCG -> CACTGAAAAGATAGCTTCGA
ACAGACCCGACTATGGCCAC -> CAGACCCGACTATGGCCACG
ACAGGAGAAGCCTATCATGG -> CAGGAGAAGCCTATCATGGT
ACAGGAGGATTGGGTTATTA -> CAGGAGGATTGGGTTATTAA
ACAGGTCTTGAATTCGATAG -> CAGGTCTTGAATTCGATAGT
ACATCACGGGTAGGCTAGCG -> CATCACGGGTAGGCTAGCGA
ACCAGCCCCAGCTATTCTAG -> CCAGCCCCAGCTATTCTAGG
ACCCAAGGACGGGAAGTTAT -> CCCAAGGACGGGAAGTTATC
ACCCATCCCGGCGCAGAAAT -> CCCATCCCGGCGCAGAAATC
ACCCGACTATGGCCACGTTG -> CCCGACTATGGCCACGTTGC
ACCCGATCTAGACGTTCTCT -> CCCGATCTAGACGTTCTCTA
ACCCTTCGTAAAGTCGCTAC -> CCCTTCGTAAAGTCGCTACC
ACCGAGTACTCTGAAGCTCA -> CCGAGTACTCTGAAGCTCAC
ACCGGCTTGGGCCCTATACG -> CCGGCTTGGGCCCTATACGC
ACCTAAGTGCTTTGGGCGAT -> CCTAAGTGCTTTGGGCGATA
ACCTATCACCGAGTACTCTG -> CCTATCACCGAGTACTCTGA
ACCTATGTCATGCAGACCAG -> CCTATGTCATGCAGACCAGC
ACCTCGCCTTTGTAAGAGTG -> CCTCGCCTTTGTAAGAGTGC
ACCTTACTGGTAATCTGGAA -> CCTTACTGGTAATCTGGAAA
ACCTTCTCAACAAGGCGGTG -> CCTTCTCAACAAGGCGGTGC
ACGACAACAGACCCGACTAT -> CGACAACAGACCCGACTATG
ACGAGCTGGGGCCAATCTCA -> CGAGCTGGGGCCAATCTCAA
ACGATTAGACACCGGCTTGG -> CGATTAGACACCGGCTTGGG
ACGCAGGACCTATGTCATGC -> CGCAGGACCTATGTCATGCA
ACGCGAAAGACCCTTCGTAA -> CGCGAAAGACCCTTCGTAAA
ACGGGAAGTTATCAGACAGG -> CGGGAAGTTATCAGACAGGT
ACGGGGCTGAAGCTTGGTGT -> CGGGGCTGAAGCTTGGTGTT
ACGGGTAGGCTAGCGACTAT -> CGGGTAGGCTAGCGACTATC
ACGGTGAATGACTAAACACG -> CGGTGAATGACTAAACACGG
ACGTCATGTTCAACTTTCCC -> CGTCATGTTCAACTTTCCCT
ACGTCTGGAAGGGGGGATTG -> CGTCTGGAAGGGGGGATTGC
ACGTTCTCTACACGAGCTGG -> CGTTCTCTACACGAGCTGGG
ACGTTGCGCGAGAGCCTGGT -> CGTTGCGCGAGAGCCTGGTC
ACTAAACACGGGGCTGAAGC -> CTAAACACGGGGCTGAAGCT
ACTACCTAAGTGCTTTGGGC -> CTACCTAAGTGCTTTGGGCG
ACTATCACGATTAGACACCG -> CTATCACGATTAGACACCGG
ACTATCTTGAGCATAAACTA -> CTATCTTGAGCATAAACTAC
ACTATGGCCACGTTGCGCGA -> CTATGGCCACGTTGCGCGAG
ACTATGTAAGTGGCGTCGCC -> CTATGTAAGTGGCGTCGCCC
ACTCCCGAACTCTGGTGTTA -> CTCCCGAACTCTGGTGTTAC
ACTCTGAAGCTCACAAGAGC -> CTCTGAAGCTCACAAGAGCG
ACTCTGGTGTTACCCATCCC -> CTCTGGTGTTACCCATCCCG
ACTGAAAAGATAGCTTCGAG -> CTGAAAAGATAGCTTCGAGT
ACTGATGGGTTTCCACGTCA -> CTGATGGGTTTCCACGTCAT
ACTGGTAATCTGGAAACAAT -> CTGGTAATCTGGAAACAATT
ACTGTGATGCCTTGAAAAAA -> CTGTGATGCCTTGAAAAAAG
ACTTATCCGCACTGTGATGC -> CTTATCCGCACTGTGATGCC
ACTTCAAGCCGGCCTCTGGG -> CTTCAAGCCGGCCTCTGGGG
ACTTGCATATCCTTTTTTGG -> CTTGCATATCCTTTTTTGGG
ACTTTCCCTCGACGACAACA -> CTTTCCCTCGACGACAACAG
AGAAATCTTAGCAGACTATC -> GAAATCTTAGCAGACTATCA
AGAAGAATAAGACGGTGAAT -> GAAGAATAAGACGGTGAATG
AGAAGCCTATCATGGTCGCT -> GAAGCCTATCATGGTCGCTT
AGAATAAGACGGTGAATGAC -> GAATAAGACGGTGAATGACT
AGACACCGGCTTGGGCCCTA -> GACACCGGCTTGGGCCCTAT
AGACAGGTCTTGAATTCGAT -> GACAGGTCTTGAATTCGATA
AGACCAGCCCCAGCTATTCT -> GACCAGCCCCAGCTATTCTA
AGACCCGACTATGGCCACGT -> GACCCGACTATGGCCACGTT
AGACCCTTCGTAAAGTCGCT -> GACCCTTCGTAAAGTCGCTA
AGACGGTGAATGACTAAACA -> GACGGTGAATGACTAAACAC
AGACGTTCTCTACACGAGCT -> GACGTTCTCTACACGAGCTG
AGACTATCACGATTAGACAC -> GACTATCACGATTAGACACC
AGACTCCCGAACTCTGGTGT -> GACTCCCGAACTCTGGTGTT
AGAGCGACATCACGGGTAGG -> GAGCGACATCACGGGTAGGC
AGAGTCGATGAGCCTTGCTT -> GAGTCGATGAGCCTTGCTTC
AGAGTGCCAGGTTGATAACC -> GAGTGCCAGGTTGATAACCT
AGATAGCTTCGAGTCGAGGT -> GATAGCTTCGAGTCGAGGTT
AGATCACTTGCATATCCTTT -> GATCACTTGCATATCCTTTT
AGATTGAAATCCGTATATGA -> GATTGAAATCCGTATATGAC
AGCAGACTATCACGATTAGA -> GCAGACTATCACGATTAGAC
AGCAGGTGGCCGCGATCAAG -> GCAGGTGGCCGCGATCAAGC
AGCATAAACTACCTAAGTGC -> GCATAAACTACCTAAGTGCT
AGCATTACAGGAGAAGCCTA -> GCATTACAGGAGAAGCCTAT
AGCCCCAGCTATTCTAGGTG -> GCCCCAGCTATTCTAGGTGA
AGCCGGCCTCTGGGGGTGCG -> GCCGGCCTCTGGGGGTGCGA
AGCCTATCATGGTCGCTTTG -> GCCTATCATGGTCGCTTTGG
AGCCTTGCTTCCTGTTTGCA -> GCCTTGCTTCCTGTTTGCAA
AGCGACATCACGGGTAGGCT -> GCGACATCACGGGTAGGCTA
AGCGACTATCTTGAGCATAA -> GCGACTATCTTGAGCATAAA
AGCGCCACGTCTGGAAGGGG -> GCGCCACGTCTGGAAGGGGG
AGCTATTCTAGGTGATTAAG -> GCTATTCTAGGTGATTAAGT
AGCTCACAAGAGCGACATCA -> GCTCACAAGAGCGACATCAC
AGCTGGCAAGCAGGTGGCCG -> GCTGGCAAGCAGGTGGCCGC
AGCTGGGGCCAATCTCAATA -> GCTGGGGCCAATCTCAATAG
AGCTTCGAGTCGAGGTTCGG -> GCTTCGAGTCGAGGTTCGGA
AGCTTGGTGTTTTCATTGGA -> GCTTGGTGTTTTCATTGGAA
AGGACCCGATCTAGACGTTC -> GGACCCGATCTAGACGTTCT
AGGACCTATGTCATGCAGAC -> GGACCTATGTCATGCAGACC
AGGACGGGAAGTTATCAGAC -> GGACGGGAAGTTATCAGACA
AGGAGAAGCCTATCATGGTC -> GGAGAAGCCTATCATGGTCG
AGGAGGATAGGTGGATACTG -> GGAGGATAGGTGGATACTGA
AGGAGGATTGGGTTATTAAA -> GGAGGATTGGGTTATTAAAA
AGGATAGGTGGATACTGATG -> GGATAGGTGGATACTGATGG
AGGATTGGGTTATTAAAAGG -> GGATTGGGTTATTAAAAGGG
AGGCCAGTCTGAAATAGGAC -> GGCCAGTCTGAAATAGGACC
AGGCGGTGCTATTTGGCCGG -> GGCGGTGCTATTTGGCCGGA
AGGCTAGCGACTATCTTGAG -> GGCTAGCGACTATCTTGAGC
AGGGGAGGCCAGTCTGAAAT -> GGGGAGGCCAGTCTGAAATA
AGGGGGGATTGCCCAGTATG -> GGGGGGATTGCCCAGTATGC
AGGGTCCCGCCCGCCCAACT -> GGGTCCCGCCCGCCCAACTT
AGGTCTTGAATTCGATAGTG -> GGTCTTGAATTCGATAGTGC
AGGTGATTAAGTATACCCAA -> GGTGATTAAGTATACCCAAG
AGGTGGATACTGATGGGTTT -> GGTGGATACTGATGGGTTTC
AGGTGGCCGCGATCAAGCAT -> GGTGGCCGCGATCAAGCATT
AGGTTCGGAAATACACCTCG -> GGTTCGGAAATACACCTCGC
AGGTTGATAACCTTCTCAAC -> GGTTGATAACCTTCTCAACA
AGTACTCTGAAGCTCACAAG -> GTACTCTGAAGCTCACAAGA
AGTAGAAGAATAAGACGGTG -> GTAGAAGAATAAGACGGTGA
AGTATACCCAAGGACGGGAA -> GTATACCCAAGGACGGGAAG
AGTATGCGGGATTGTTGAGG -> GTATGCGGGATTGTTGAGGG
AGTCCGTTAAGCTGGCAAGC -> GTCCGTTAAGCTGGCAAGCA
AGTCGAGGTTCGGAAATACA -> GTCGAGGTTCGGAAATACAC
AGTCGATGAGCCTTGCTTCC -> GTCGATGAGCCTTGCTTCCT
AGTCGCTACCTTACTGGTAA -> GTCGCTACCTTACTGGTAAT
AGTCTGAAATAGGACCCGAT -> GTCTGAAATAGGACCCGATC
AGTGCCAGATTGAAATCCGT -> GTGCCAGATTGAAATCCGTA
AGTGCCAGGTTGATAACCTT -> GTGCCAGGTTGATAACCTTC
AGTGCTTTGGGCGATAGAGT -> GTGCTTTGGGCGATAGAGTC
AGTGGCGTCGCCCATGGTTG -> GTGGCGTCGCCCATGGTTGT
AGTTATCAGACAGGTCTTGA -> GTTATCAGACAGGTCTTGAA
ATAAACGCAGGACCTATGTC -> TAAACGCAGGACCTATGTCA
ATAAACTACCTAAGTGCTTT -> TAAACTACCTAAGTGCTTTG
ATAACCTTCTCAACAAGGCG -> TAACCTTCTCAACAAGGCGG
ATAAGACGGTGAATGACTAA -> TAAGACGGTGAATGACTAAA
ATACACCTCGCCTTTGTAAG -> TACACCTCGCCTTTGTAAGA
ATACCCAAGGACGGGAAGTT -> TACCCAAGGACGGGAAGTTA
ATACGCGAAAGACCCTTCGT -> TACGCGAAAGACCCTTCGTA
ATACTGATGGGTTTCCACGT -> TACTGATGGGTTTCCACGTC
ATAGAGTCGATGAGCCTTGC -> TAGAGTCGATGAGCCTTGCT
ATAGCTTCGAGTCGAGGTTC -> TAGCTTCGAGTCGAGGTTCG
ATAGGACCCGATCTAGACGT -> TAGGACCCGATCTAGACGTT
ATAGGAGGATAGGTGGATAC -> TAGGAGGATAGGTGGATACT
ATAGGTGGATACTGATGGGT -> TAGGTGGATACTGATGGGTT
ATAGTGCCAGATTGAAATCC -> TAGTGCCAGATTGAAATCCG
ATATCCTTTTTTGGGCCAGT -> TATCCTTTTTTGGGCCAGTA
ATATGACCTATCACCGAGTA -> TATGACCTATCACCGAGTAC
ATATTACACTGAAAAGATAG -> TATTACACTGAAAAGATAGC
ATCAAGCATTACAGGAGAAG -> TCAAGCATTACAGGAGAAGC
ATCACCGAGTACTCTGAAGC -> TCACCGAGTACTCTGAAGCT
ATCACGATTAGACACCGGCT -> TCACGATTAGACACCGGCTT
ATCACGGGTAGGCTAGCGAC -> TCACGGGTAGGCTAGCGACT
ATCACTTGCATATCCTTTTT -> TCACTTGCATATCCTTTTTT
ATCAGACAGGTCTTGAATTC -> TCAGACAGGTCTTGAATTCG
ATCATGGTCGCTTTGGAGCG -> TCATGGTCGCTTTGGAGCGC
ATCCCGGCGCAGAAATCTTA -> TCCCGGCGCAGAAATCTTAG
ATCCGCACTGTGATGCCTTG -> TCCGCACTGTGATGCCTTGA
ATCCGTATATGACCTATCAC -> TCCGTATATGACCTATCACC
ATCCTTTTTTGGGCCAGTAG -> TCCTTTTTTGGGCCAGTAGA
ATCTAGACGTTCTCTACACG -> TCTAGACGTTCTCTACACGA
ATCTCAATAGGAGGATAGGT -> TCTCAATAGGAGGATAGGTG
ATCTGGAAACAATTCGTCAA -> TCTGGAAACAATTCGTCAAC
ATCTTAGCAGACTATCACGA -> TCTTAGCAGACTATCACGAT
ATCTTGAGCATAAACTACCT -> TCTTGAGCATAAACTACCTA
ATGACCTATCACCGAGTACT -> TGACCTATCACCGAGTACTC
ATGACTAAACACGGGGCTGA -> TGACTAAACACGGGGCTGAA
ATGAGCCTTGCTTCCTGTTT -> TGAGCCTTGCTTCCTGTTTG
ATGCAGACCAGCCCCAGCTA -> TGCAGACCAGCCCCAGCTAT
ATGCCTTGAAAAAAGACTCC -> TGCCTTGAAAAAAGACTCCC
ATGCGGGATTGTTGAGGGTC -> TGCGGGATTGTTGAGGGTCC
ATGGCCACGTTGCGCGAGAG -> TGGCCACGTTGCGCGAGAGC
ATGGGTTTCCACGTCATGTT -> TGGGTTTCCACGTCATGTTC
ATGGTAAACAGGAGGATTGG -> TGGTAAACAGGAGGATTGGG
ATGGTCGCTTTGGAGCGCCA -> TGGTCGCTTTGGAGCGCCAC
ATGGTTGTCATAAACGCAGG -> TGGTTGTCATAAACGCAGGA
ATGTAAGTGGCGTCGCCCAT -> TGTAAGTGGCGTCGCCCATG
ATGTCATGCAGACCAGCCCC -> TGTCATGCAGACCAGCCCCA
ATGTTCAACTTTCCCTCGAC -> TGTTCAACTTTCCCTCGACG
ATTAAAAGGGGAGGCCAGTC -> TTAAAAGGGGAGGCCAGTCT
ATTAAGTATACCCAAGGACG -> TTAAGTATACCCAAGGACGG
ATTACACTGAAAAGATAGCT -> TTACACTGAAAAGATAGCTT
ATTACAGGAGAAGCCTATCA -> TTACAGGAGAAGCCTATCAT
ATTAGACACCGGCTTGGGCC -> TTAGACACCGGCTTGGGCCC
ATTCGATAGTGCCAGATTGA -> TTCGATAGTGCCAGATTGAA
ATTCGTCAACTATGTAAGTG -> TTCGTCAACTATGTAAGTGG
ATTCTAGGTGATTAAGTATA -> TTCTAGGTGATTAAGTATAC
ATTGAAATCCGTATATGACC -> TTGAAATCCGTATATGACCT
ATTGCCCAGTATGCGGGATT -> TTGCCCAGTATGCGGGATTG
ATTGGAATGGTAAACAGGAG -> TTGGAATGGTAAACAGGAGG
ATTGGGTTATTAAAAGGGGA -> TTGGGTTATTAAAAGGGGAG
ATTGTTGAGGGTCCCGCCCG -> TTGTTGAGGGTCCCGCCCGC
ATTTGGCCGGAAAGTCCGTT -> TTTGGCCGGAAAGTCCGTTA
CAACAAGGCGGTGCTATTTG -> AACAAGGCGGTGCTATTTGG
CAACAGACCCGACTATGGCC -> AACAGACCCGACTATGGCCA
CAACTATGTAAGTGGCGTCG -> AACTATGTAAGTGGCGTCGC
CAACTTCAAGCCGGCCTCTG -> AACTTCAAGCCGGCCTCTGG
CAACTTTCCCTCGACGACAA -> AACTTTCCCTCGACGACAAC
CAAGAGCGACATCACGGGTA -> AAGAGCGACATCACGGGTAG
CAAGATCACTTGCATATCCT -> AAGATCACTTGCATATCCTT
CAAGCAGGTGGCCGCGATCA -> AAGCAGGTGGCCGCGATCAA
CAAGCATTACAGGAGAAGCC -> AAGCATTACAGGAGAAGCCT
CAAGCCGGCCTCTGGGGGTG -> AAGCCGGCCTCTGGGGGTGC
CAAGGACGGGAAGTTATCAG -> AAGGACGGGAAGTTATCAGA
CAAGGCGGTGCTATTTGGCC -> AAGGCGGTGCTATTTGGCCG
CAATAGGAGGATAGGTGGAT -> AATAGGAGGATAGGTGGATA
CAATCTCAATAGGAGGATAG -> AATCTCAATAGGAGGATAGG
CAATTCGTCAACTATGTAAG -> AATTCGTCAACTATGTAAGT
CACAAGAGCGACATCACGGG -> ACAAGAGCGACATCACGGGT
CACCGAGTACTCTGAAGCTC -> ACCGAGTACTCTGAAGCTCA
CACCGGCTTGGGCCCTATAC -> ACCGGCTTGGGCCCTATACG
CACCTCGCCTTTGTAAGAGT -> ACCTCGCCTTTGTAAGAGTG
CACGAGCTGGGGCCAATCTC -> ACGAGCTGGGGCCAATCTCA
CACGATTAGACACCGGCTTG -> ACGATTAGACACCGGCTTGG
CACGGGGCTGAAGCTTGGTG -> ACGGGGCTGAAGCTTGGTGT
CACGGGTAGGCTAGCGACTA -> ACGGGTAGGCTAGCGACTAT
CACGTCATGTTCAACTTTCC -> ACGTCATGTTCAACTTTCCC
CACGTCTGGAAGGGGGGATT -> ACGTCTGGAAGGGGGGATTG
CACGTTGCGCGAGAGCCTGG -> ACGTTGCGCGAGAGCCTGGT
CACTGAAAAGATAGCTTCGA -> ACTGAAAAGATAGCTTCGAG
CACTGTGATGCCTTGAAAAA -> ACTGTGATGCCTTGAAAAAA
CACTTGCATATCCTTTTTTG -> ACTTGCATATCCTTTTTTGG
CAGAAATCTTAGCAGACTAT -> AGAAATCTTAGCAGACTATC
CAGACAGGTCTTGAATTCGA -> AGACAGGTCTTGAATTCGAT
CAGACCAGCCCCAGCTATTC -> AGACCAGCCCCAGCTATTCT
CAGACCCGACTATGGCCACG -> AGACCCGACTATGGCCACGT
CAGACTATCACGATTAGACA -> AGACTATCACGATTAGACAC
CAGATTGAAATCCGTATATG -> AGATTGAAATCCGTATATGA
CAGCCCCAGCTATTCTAGGT -> AGCCCCAGCTATTCTAGGTG
CAGCTATTCTAGGTGATTAA -> AGCTATTCTAGGTGATTAAG
CAGGACCTATGTCATGCAGA -> AGGACCTATGTCATGCAGAC
CAGGAGAAGCCTATCATGGT -> AGGAGAAGCCTATCATGGTC
CAGGAGGATTGGGTTATTAA -> AGGAGGATTGGGTTATTAAA
CAGGTCTTGAATTCGATAGT -> AGGTCTTGAATTCGATAGTG
CAGGTGGCCGCGATCAAGCA -> AGGTGGCCGCGATCAAGCAT
CAGGTTGATAACCTTCTCAA -> AGGTTGATAACCTTCTCAAC
CAGTAGAAGAATAAGACGGT -> AGTAGAAGAATAAGACGGTG
CAGTATGCGGGATTGTTGAG -> AGTATGCGGGATTGTTGAGG
CAGTCTGAAATAGGACCCGA -> AGTCTGAAATAGGACCCGAT
CATAAACGCAGGACCTATGT -> ATAAACGCAGGACCTATGTC
CATAAACTACCTAAGTGCTT -> ATAAACTACCTAAGTGCTTT
CATATCCTTTTTTGGGCCAG -> ATATCCTTTTTTGGGCCAGT
CATCACGGGTAGGCTAGCGA -> ATCACGGGTAGGCTAGCGAC
CATCCCGGCGCAGAAATCTT -> ATCCCGGCGCAGAAATCTTA
CATGCAGACCAGCCCCAGCT -> ATGCAGACCAGCCCCAGCTA
CATGGTCGCTTTGGAGCGCC -> ATGGTCGCTTTGGAGCGCCA
CATGGTTGTCATAAACGCAG -> ATGGTTGTCATAAACGCAGG
CATGTTCAACTTTCCCTCGA -> ATGTTCAACTTTCCCTCGAC
CATTACAGGAGAAGCCTATC -> ATTACAGGAGAAGCCTATCA
CATTGGAATGGTAAACAGGA -> ATTGGAATGGTAAACAGGAG
CCAACTTCAAGCCGGCCTCT -> CAACTTCAAGCCGGCCTCTG
CCAAGGACGGGAAGTTATCA -> CAAGGACGGGAAGTTATCAG
CCAATCTCAATAGGAGGATA -> CAATCTCAATAGGAGGATAG
CCACGTCATGTTCAACTTTC -> CACGTCATGTTCAACTTTCC
CCACGTCTGGAAGGGGGGAT -> CACGTCTGGAAGGGGGGATT
CCACGTTGCGCGAGAGCCTG -> CACGTTGCGCGAGAGCCTGG
CCAGATTGAAATCCGTATAT -> CAGATTGAAATCCGTATATG
CCAGCCCCAGCTATTCTAGG -> CAGCCCCAGCTATTCTAGGT
CCAGCTATTCTAGGTGATTA -> CAGCTATTCTAGGTGATTAA
CCAGGTTGATAACCTTCTCA -> CAGGTTGATAACCTTCTCAA
CCAGTAGAAGAATAAGACGG -> CAGTAGAAGAATAAGACGGT
CCAGTATGCGGGATTGTTGA -> CAGTATGCGGGATTGTTGAG
CCAGTCTGAAATAGGACCCG -> CAGTCTGAAATAGGACCCGA
CCATCCCGGCGCAGAAATCT -> CATCCCGGCGCAGAAATCTT
CCATGGTTGTCATAAACGCA -> CATGGTTGTCATAAACGCAG
CCCAACTTCAAGCCGGCCTC -> CCAACTTCAAGCCGGCCTCT
CCCAAGGACGGGAAGTTATC -> CCAAGGACGGGAAGTTATCA
CCCAGCTATTCTAGGTGATT -> CCAGCTATTCTAGGTGATTA
CCCAGTATGCGGGATTGTTG -> CCAGTATGCGGGATTGTTGA
CCCATCCCGGCGCAGAAATC -> CCATCCCGGCGCAGAAATCT
CCCATGGTTGTCATAAACGC -> CCATGGTTGTCATAAACGCA
CCCCAGCTATTCTAGGTGAT -> CCCAGCTATTCTAGGTGATT
CCCGAACTCTGGTGTTACCC -> CCGAACTCTGGTGTTACCCA
CCCGACTATGGCCACGTTGC -> CCGACTATGGCCACGTTGCG
CCCGATCTAGACGTTCTCTA -> CCGATCTAGACGTTCTCTAC
CCCGCCCAACTTCAAGCCGG -> CCGCCCAACTTCAAGCCGGC
CCCGCCCGCCCAACTTCAAG -> CCGCCCGCCCAACTTCAAGC
CCCGGCGCAGAAATCTTAGC -> CCGGCGCAGAAATCTTAGCA
CCCTATACGCGAAAGACCCT -> CCTATACGCGAAAGACCCTT
CCCTCGACGACAACAGACCC -> CCTCGACGACAACAGACCCG
CCCTTCGTAAAGTCGCTACC -> CCTTCGTAAAGTCGCTACCT
CCGAACTCTGGTGTTACCCA -> CGAACTCTGGTGTTACCCAT
CCGACTATGGCCACGTTGCG -> CGACTATGGCCACGTTGCGC
CCGAGTACTCTGAAGCTCAC -> CGAGTACTCTGAAGCTCACA
CCGATCTAGACGTTCTCTAC -> CGATCTAGACGTTCTCTACA
CCGCACTGTGATGCCTTGAA -> CGCACTGTGATGCCTTGAAA
CCGCCCAACTTCAAGCCGGC -> CGCCCAACTTCAAGCCGGCC
CCGCCCGCCCAACTTCAAGC -> CGCCCGCCCAACTTCAAGCC
CCGCGATCAAGCATTACAGG -> CGCGATCAAGCATTACAGGA
CCGGAAAGTCCGTTAAGCTG -> CGGAAAGTCCGTTAAGCTGG
CCGGCCTCTGGGGGTGCGAC -> CGGCCTCTGGGGGTGCGACT
CCGGCGCAGAAATCTTAGCA -> CGGCGCAGAAATCTTAGCAG
CCGGCTTGGGCCCTATACGC -> CGGCTTGGGCCCTATACGCG
CCGTATATGACCTATCACCG -> CGTATATGACCTATCACCGA
CCGTTAAGCTGGCAAGCAGG -> CGTTAAGCTGGCAAGCAGGT
CCTAAGTGCTTTGGGCGATA -> CTAAGTGCTTTGGGCGATAG
CCTATACGCGAAAGACCCTT -> CTATACGCGAAAGACCCTTC
CCTATCACCGAGTACTCTGA -> CTATCACCGAGTACTCTGAA
CCTATCATGGTCGCTTTGGA -> CTATCATGGTCGCTTTGGAG
CCTATGTCATGCAGACCAGC -> CTATGTCATGCAGACCAGCC
CCTCGACGACAACAGACCCG -> CTCGACGACAACAGACCCGA
CCTCGCCTTTGTAAGAGTGC -> CTCGCCTTTGTAAGAGTGCC
CCTCTGGGGGTGCGACTTAT -> CTCTGGGGGTGCGACTTATC
CCTGTTTGCAAGATCACTTG -> CTGTTTGCAAGATCACTTGC
CCTTACTGGTAATCTGGAAA -> CTTACTGGTAATCTGGAAAC
CCTTCGTAAAGTCGCTACCT -> CTTCGTAAAGTCGCTACCTT
CCTTCTCAACAAGGCGGTGC -> CTTCTCAACAAGGCGGTGCT
CCTTGAAAAAAGACTCCCGA -> CTTGAAAAAAGACTCCCGAA
CCTTGCTTCCTGTTTGCAAG -> CTTGCTTCCTGTTTGCAAGA
CCTTTGTAAGAGTGCCAGGT -> CTTTGTAAGAGTGCCAGGTT
CCTTTTTTGGGCCAGTAGAA -> CTTTTTTGGGCCAGTAGAAG
CGAAAGACCCTTCGTAAAGT -> GAAAGACCCTTCGTAAAGTC
CGAACTCTGGTGTTACCCAT -> GAACTCTGGTGTTACCCATC
CGACAACAGACCCGACTATG -> GACAACAGACCCGACTATGG
CGACATCACGGGTAGGCTAG -> GACATCACGGGTAGGCTAGC
CGACGACAACAGACCCGACT -> GACGACAACAGACCCGACTA
CGACTATCTTGAGCATAAAC -> GACTATCTTGAGCATAAACT
CGACTATGGCCACGTTGCGC -> GACTATGGCCACGTTGCGCG
CGACTTATCCGCACTGTGAT -> GACTTATCCGCACTGTGATG
CGAGCTGGGGCCAATCTCAA -> GAGCTGGGGCCAATCTCAAT
CGAGGTTCGGAAATACACCT -> GAGGTTCGGAAATACACCTC
CGAGTACTCTGAAGCTCACA -> GAGTACTCTGAAGCTCACAA
CGAGTCGAGGTTCGGAAATA -> GAGTCGAGGTTCGGAAATAC
CGATAGAGTCGATGAGCCTT -> GATAGAGTCGATGAGCCTTG
CGATAGTGCCAGATTGAAAT -> GATAGTGCCAGATTGAAATC
CGATCAAGCATTACAGGAGA -> GATCAAGCATTACAGGAGAA
CGATCTAGACGTTCTCTACA -> GATCTAGACGTTCTCTACAC
CGATGAGCCTTGCTTCCTGT -> GATGAGCCTTGCTTCCTGTT
CGATTAGACACCGGCTTGGG -> GATTAGACACCGGCTTGGGC
CGCACTGTGATGCCTTGAAA -> GCACTGTGATGCCTTGAAAA
CGCAGAAATCTTAGCAGACT -> GCAGAAATCTTAGCAGACTA
CGCAGGACCTATGTCATGCA -> GCAGGACCTATGTCATGCAG
CGCCACGTCTGGAAGGGGGG -> GCCACGTCTGGAAGGGGGGA
CGCCCAACTTCAAGCCGGCC -> GCCCAACTTCAAGCCGGCCT
CGCCCATGGTTGTCATAAAC -> GCCCATGGTTGTCATAAACG
CGCCCGCCCAACTTCAAGCC -> GCCCGCCCAACTTCAAGCCG
CGCCTTTGTAAGAGTGCCAG -> GCCTTTGTAAGAGTGCCAGG
CGCGAAAGACCCTTCGTAAA -> GCGAAAGACCCTTCGTAAAG
CGCGATCAAGCATTACAGGA -> GCGATCAAGCATTACAGGAG
CGCTACCTTACTGGTAATCT -> GCTACCTTACTGGTAATCTG
CGCTTTGGAGCGCCACGTCT -> GCTTTGGAGCGCCACGTCTG
CGGAAAGTCCGTTAAGCTGG -> GGAAAGTCCGTTAAGCTGGC
CGGAAATACACCTCGCCTTT -> GGAAATACACCTCGCCTTTG
CGGCCTCTGGGGGTGCGACT -> GGCCTCTGGGGGTGCGACTT
CGGCGCAGAAATCTTAGCAG -> GGCGCAGAAATCTTAGCAGA
CGGCTTGGGCCCTATACGCG -> GGCTTGGGCCCTATACGCGA
CGGGAAGTTATCAGACAGGT -> GGGAAGTTATCAGACAGGTC
CGGGATTGTTGAGGGTCCCG -> GGGATTGTTGAGGGTCCCGC
CGGGGCTGAAGCTTGGTGTT -> GGGGCTGAAGCTTGGTGTTT
CGGGTAGGCTAGCGACTATC -> GGGTAGGCTAGCGACTATCT
CGGTGAATGACTAAACACGG -> GGTGAATGACTAAACACGGG
CGGTGCTATTTGGCCGGAAA -> GGTGCTATTTGGCCGGAAAG
CGTAAAGTCGCTACCTTACT -> GTAAAGTCGCTACCTTACTG
CGTATATGACCTATCACCGA -> GTATATGACCTATCACCGAG
CGTCAACTATGTAAGTGGCG -> GTCAACTATGTAAGTGGCGT
CGTCATGTTCAACTTTCCCT -> GTCATGTTCAACTTTCCCTC
CGTCGCCCATGGTTGTCATA -> GTCGCCCATGGTTGTCATAA
CGTCTGGAAGGGGGGATTGC -> GTCTGGAAGGGGGGATTGCC
CGTTAAGCTGGCAAGCAGGT -> GTTAAGCTGGCAAGCAGGTG
CGTTCTCTACACGAGCTGGG -> GTTCTCTACACGAGCTGGGG
CGTTGCGCGAGAGCCTGGTC -> GTTGCGCGAGAGCCTGGTCT
CTAAACACGGGGCTGAAGCT -> TAAACACGGGGCTGAAGCTT
CTAAGTGCTTTGGGCGATAG -> TAAGTGCTTTGGGCGATAGA
CTACACGAGCTGGGGCCAAT -> TACACGAGCTGGGGCCAATC
CTACCTAAGTGCTTTGGGCG -> TACCTAAGTGCTTTGGGCGA
CTACCTTACTGGTAATCTGG -> TACCTTACTGGTAATCTGGA
CTAGACGTTCTCTACACGAG -> TAGACGTTCTCTACACGAGC
CTAGCGACTATCTTGAGCAT -> TAGCGACTATCTTGAGCATA
CTAGGTGATTAAGTATACCC -> TAGGTGATTAAGTATACCCA
CTATACGCGAAAGACCCTTC -> TATACGCGAAAGACCCTTCG
CTATCACCGAGTACTCTGAA -> TATCACCGAGTACTCTGAAG
CTATCACGATTAGACACCGG -> TATCACGATTAGACACCGGC
CTATCATGGTCGCTTTGGAG -> TATCATGGTCGCTTTGGAGC
CTATCTTGAGCATAAACTAC -> TATCTTGAGCATAAACTACC
CTATGGCCACGTTGCGCGAG -> TATGGCCACGTTGCGCGAGA
CTATGTAAGTGGCGTCGCCC -> TATGTAAGTGGCGTCGCCCA
CTATGTCATGCAGACCAGCC -> TATGTCATGCAGACCAGCCC
CTATTCTAGGTGATTAAGTA -> TATTCTAGGTGATTAAGTAT
CTATTTGGCCGGAAAGTCCG -> TATTTGGCCGGAAAGTCCGT
CTCAACAAGGCGGTGCTATT -> TCAACAAGGCGGTGCTATTT
CTCAATAGGAGGATAGGTGG -> TCAATAGGAGGATAGGTGGA
CTCACAAGAGCGACATCACG -> TCACAAGAGCGACATCACGG
CTCCCGAACTCTGGTGTTAC -> TCCCGAACTCTGGTGTTACC
CTCGACGACAACAGACCCGA -> TCGACGACAACAGACCCGAC
CTCGCCTTTGTAAGAGTGCC -> TCGCCTTTGTAAGAGTGCCA
CTCTACACGAGCTGGGGCCA -> TCTACACGAGCTGGGGCCAA
CTCTGAAGCTCACAAGAGCG -> TCTGAAGCTCACAAGAGCGA
CTCTGGGGGTGCGACTTATC -> TCTGGGGGTGCGACTTATCC
CTCTGGTGTTACCCATCCCG -> TCTGGTGTTACCCATCCCGG
CTGAAAAGATAGCTTCGAGT -> TGAAAAGATAGCTTCGAGTC
CTGAAATAGGACCCGATCTA -> TGAAATAGGACCCGATCTAG
CTGAAGCTCACAAGAGCGAC -> TGAAGCTCACAAGAGCGACA
CTGAAGCTTGGTGTTTTCAT -> TGAAGCTTGGTGTTTTCATT
CTGATGGGTTTCCACGTCAT -> TGATGGGTTTCCACGTCATG
CTGGAAACAATTCGTCAACT -> TGGAAACAATTCGTCAACTA
CTGGAAGGGGGGATTGCCCA -> TGGAAGGGGGGATTGCCCAG
CTGGCAAGCAGGTGGCCGCG -> TGGCAAGCAGGTGGCCGCGA
CTGGGGCCAATCTCAATAGG -> TGGGGCCAATCTCAATAGGA
CTGGGGGTGCGACTTATCCG -> TGGGGGTGCGACTTATCCGC
CTGGTAATCTGGAAACAATT -> TGGTAATCTGGAAACAATTC
CTGGTGTTACCCATCCCGGC -> TGGTGTTACCCATCCCGGCG
CTGTGATGCCTTGAAAAAAG -> TGTGATGCCTTGAAAAAAGA
CTGTTTGCAAGATCACTTGC -> TGTTTGCAAGATCACTTGCA
CTTACTGGTAATCTGGAAAC -> TTACTGGTAATCTGGAAACA
CTTAGCAGACTATCACGATT -> TTAGCAGACTATCACGATTA
CTTATCCGCACTGTGATGCC -> TTATCCGCACTGTGATGCCT
CTTCAAGCCGGCCTCTGGGG -> TTCAAGCCGGCCTCTGGGGG
CTTCCTGTTTGCAAGATCAC -> TTCCTGTTTGCAAGATCACT
CTTCGAGTCGAGGTTCGGAA -> TTCGAGTCGAGGTTCGGAAA
CTTCGTAAAGTCGCTACCTT -> TTCGTAAAGTCGCTACCTTA
CTTCTCAACAAGGCGGTGCT -> TTCTCAACAAGGCGGTGCTA
CTTGAAAAAAGACTCCCGAA -> TTGAAAAAAGACTCCCGAAC
CTTGAATTCGATAGTGCCAG -> TTGAATTCGATAGTGCCAGA
CTTGAGCATAAACTACCTAA -> TTGAGCATAAACTACCTAAG
CTTGCATATCCTTTTTTGGG -> TTGCATATCCTTTTTTGGGC
CTTGCTTCCTGTTTGCAAGA -> TTGCTTCCTGTTTGCAAGAT
CTTGGGCCCTATACGCGAAA -> TTGGGCCCTATACGCGAAAG
CTTGGTGTTTTCATTGGAAT -> TTGGTGTTTTCATTGGAATG
CTTTCCCTCGACGACAACAG -> TTTCCCTCGACGACAACAGA
CTTTGGAGCGCCACGTCTGG -> TTTGGAGCGCCACGTCTGGA
CTTTGGGCGATAGAGTCGAT -> TTTGGGCGATAGAGTCGATG
CTTTGTAAGAGTGCCAGGTT -> TTTGTAAGAGTGCCAGGTTG
CTTTTTTGGGCCAGTAGAAG -> TTTTTTGGGCCAGTAGAAGA
GAAAAAAGACTCCCGAACTC -> AAAAAAGACTCCCGAACTCT
GAAAAGATAGCTTCGAGTCG -> AAAAGATAGCTTCGAGTCGA
GAAACAATTCGTCAACTATG -> AAACAATTCGTCAACTATGT
GAAAGACCCTTCGTAAAGTC -> AAAGACCCTTCGTAAAGTCG
GAAAGTCCGTTAAGCTGGCA -> AAAGTCCGTTAAGCTGGCAA
GAAATACACCTCGCCTTTGT -> AAATACACCTCGCCTTTGTA
GAAATAGGACCCGATCTAGA -> AAATAGGACCCGATCTAGAC
GAAATCCGTATATGACCTAT -> AAATCCGTATATGACCTATC
GAAATCTTAGCAGACTATCA -> AAATCTTAGCAGACTATCAC
GAACTCTGGTGTTACCCATC -> AACTCTGGTGTTACCCATCC
GAAGAATAAGACGGTGAATG -> AAGAATAAGACGGTGAATGA
GAAGCCTATCATGGTCGCTT -> AAGCCTATCATGGTCGCTTT
GAAGCTCACAAGAGCGACAT -> AAGCTCACAAGAGCGACATC
GAAGCTTGGTGTTTTCATTG -> AAGCTTGGTGTTTTCATTGG
GAAGGGGGGATTGCCCAGTA -> AAGGGGGGATTGCCCAGTAT
GAAGTTATCAGACAGGTCTT -> AAGTTATCAGACAGGTCTTG
GAATAAGACGGTGAATGACT -> AATAAGACGGTGAATGACTA
GAATGACTAAACACGGGGCT -> AATGACTAAACACGGGGCTG
GAATGGTAAACAGGAGGATT -> AATGGTAAACAGGAGGATTG
GAATTCGATAGTGCCAGATT -> AATTCGATAGTGCCAGATTG
GACAACAGACCCGACTATGG -> ACAACAGACCCGACTATGGC
GACACCGGCTTGGGCCCTAT -> ACACCGGCTTGGGCCCTATA
GACAGGTCTTGAATTCGATA -> ACAGGTCTTGAATTCGATAG
GACATCACGGGTAGGCTAGC -> ACATCACGGGTAGGCTAGCG
GACCAGCCCCAGCTATTCTA -> ACCAGCCCCAGCTATTCTAG
GACCCGACTATGGCCACGTT -> ACCCGACTATGGCCACGTTG
GACCCGATCTAGACGTTCTC -> ACCCGATCTAGACGTTCTCT
GACCCTTCGTAAAGTCGCTA -> ACCCTTCGTAAAGTCGCTAC
GACCTATCACCGAGTACTCT -> ACCTATCACCGAGTACTCTG
GACCTATGTCATGCAGACCA -> ACCTATGTCATGCAGACCAG
GACGACAACAGACCCGACTA -> ACGACAACAGACCCGACTAT
GACGGGAAGTTATCAGACAG -> ACGGGAAGTTATCAGACAGG
GACGGTGAATGACTAAACAC -> ACGGTGAATGACTAAACACG
GACGTTCTCTACACGAGCTG -> ACGTTCTCTACACGAGCTGG
GACTAAACACGGGGCTGAAG -> ACTAAACACGGGGCTGAAGC
GACTATCACGATTAGACACC -> ACTATCACGATTAGACACCG
GACTATCTTGAGCATAAACT -> ACTATCTTGAGCATAAACTA
GACTATGGCCACGTTGCGCG -> ACTATGGCCACGTTGCGCGA
GACTCCCGAACTCTGGTGTT -> ACTCCCGAACTCTGGTGTTA
GACTTATCCGCACTGTGATG -> ACTTATCCGCACTGTGATGC
GAGAAGCCTATCATGGTCGC -> AGAAGCCTATCATGGTCGCT
GAGCATAAACTACCTAAGTG -> AGCATAAACTACCTAAGTGC
GAGCCTTGCTTCCTGTTTGC -> AGCCTTGCTTCCTGTTTGCA
GAGCGACATCACGGGTAGGC -> AGCGACATCACGGGTAGGCT
GAGCGCCACGTCTGGAAGGG -> AGCGCCACGTCTGGAAGGGG
GAGCTGGGGCCAATCTCAAT -> AGCTGGGGCCAATCTCAATA
GAGGATAGGTGGATACTGAT -> AGGATAGGTGGATACTGATG
GAGGATTGGGTTATTAAAAG -> AGGATTGGGTTATTAAAAGG
GAGGCCAGTCTGAAATAGGA -> AGGCCAGTCTGAAATAGGAC
GAGGGTCCCGCCCGCCCAAC -> AGGGTCCCGCCCGCCCAACT
GAGGTTCGGAAATACACCTC -> AGGTTCGGAAATACACCTCG
GAGTACTCTGAAGCTCACAA -> AGTACTCTGAAGCTCACAAG
GAGTCGAGGTTCGGAAATAC -> AGTCGAGGTTCGGAAATACA
GAGTCGATGAGCCTTGCTTC -> AGTCGATGAGCCTTGCTTCC
GAGTGCCAGGTTGATAACCT -> AGTGCCAGGTTGATAACCTT
GATAACCTTCTCAACAAGGC -> ATAACCTTCTCAACAAGGCG
GATACTGATGGGTTTCCACG -> ATACTGATGGGTTTCCACGT
GATAGAGTCGATGAGCCTTG -> ATAGAGTCGATGAGCCTTGC
GATAGCTTCGAGTCGAGGTT -> ATAGCTTCGAGTCGAGGTTC
GATAGGTGGATACTGATGGG -> ATAGGTGGATACTGATGGGT
GATAGTGCCAGATTGAAATC -> ATAGTGCCAGATTGAAATCC
GATCAAGCATTACAGGAGAA -> ATCAAGCATTACAGGAGAAG
GATCACTTGCATATCCTTTT -> ATCACTTGCATATCCTTTTT
GATCTAGACGTTCTCTACAC -> ATCTAGACGTTCTCTACACG
GATGAGCCTTGCTTCCTGTT -> ATGAGCCTTGCTTCCTGTTT
GATGCCTTGAAAAAAGACTC -> ATGCCTTGAAAAAAGACTCC
GATGGGTTTCCACGTCATGT -> ATGGGTTTCCACGTCATGTT
GATTAAGTATACCCAAGGAC -> ATTAAGTATACCCAAGGACG
GATTAGACACCGGCTTGGGC -> ATTAGACACCGGCTTGGGCC
GATTGAAATCCGTATATGAC -> ATTGAAATCCGTATATGACC
GATTGCCCAGTATGCGGGAT -> ATTGCCCAGTATGCGGGATT
GATTGGGTTATTAAAAGGGG -> ATTGGGTTATTAAAAGGGGA
GATTGTTGAGGGTCCCGCCC -> ATTGTTGAGGGTCCCGCCCG
GCAAGATCACTTGCATATCC -> CAAGATCACTTGCATATCCT
GCAAGCAGGTGGCCGCGATC -> CAAGCAGGTGGCCGCGATCA
GCACTGTGATGCCTTGAAAA -> CACTGTGATGCCTTGAAAAA
GCAGAAATCTTAGCAGACTA -> CAGAAATCTTAGCAGACTAT
GCAGACCAGCCCCAGCTATT -> CAGACCAGCCCCAGCTATTC
GCAGACTATCACGATTAGAC -> CAGACTATCACGATTAGACA
GCAGGACCTATGTCATGCAG -> CAGGACCTATGTCATGCAGA
GCAGGTGGCCGCGATCAAGC -> CAGGTGGCCGCGATCAAGCA
GCATAAACTACCTAAGTGCT -> CATAAACTACCTAAGTGCTT
GCATATCCTTTTTTGGGCCA -> CATATCCTTTTTTGGGCCAG
GCATTACAGGAGAAGCCTAT -> CATTACAGGAGAAGCCTATC
GCCAATCTCAATAGGAGGAT -> CCAATCTCAATAGGAGGATA
GCCACGTCTGGAAGGGGGGA -> CCACGTCTGGAAGGGGGGAT
GCCACGTTGCGCGAGAGCCT -> CCACGTTGCGCGAGAGCCTG
GCCAGATTGAAATCCGTATA -> CCAGATTGAAATCCGTATAT
GCCAGGTTGATAACCTTCTC -> CCAGGTTGATAACCTTCTCA
GCCAGTAGAAGAATAAGACG -> CCAGTAGAAGAATAAGACGG
GCCAGTCTGAAATAGGACCC -> CCAGTCTGAAATAGGACCCG
GCCCAACTTCAAGCCGGCCT -> CCCAACTTCAAGCCGGCCTC
GCCCAGTATGCGGGATTGTT -> CCCAGTATGCGGGATTGTTG
GCCCATGGTTGTCATAAACG -> CCCATGGTTGTCATAAACGC
GCCCCAGCTATTCTAGGTGA -> CCCCAGCTATTCTAGGTGAT
GCCCGCCCAACTTCAAGCCG -> CCCGCCCAACTTCAAGCCGG
GCCCTATACGCGAAAGACCC -> CCCTATACGCGAAAGACCCT
GCCGCGATCAAGCATTACAG -> CCGCGATCAAGCATTACAGG
GCCGGAAAGTCCGTTAAGCT -> CCGGAAAGTCCGTTAAGCTG
GCCGGCCTCTGGGGGTGCGA -> CCGGCCTCTGGGGGTGCGAC
GCCTATCATGGTCGCTTTGG -> CCTATCATGGTCGCTTTGGA
GCCTCTGGGGGTGCGACTTA -> CCTCTGGGGGTGCGACTTAT
GCCTTGAAAAAAGACTCCCG -> CCTTGAAAAAAGACTCCCGA
GCCTTGCTTCCTGTTTGCAA -> CCTTGCTTCCTGTTTGCAAG
GCCTTTGTAAGAGTGCCAGG -> CCTTTGTAAGAGTGCCAGGT
GCGAAAGACCCTTCGTAAAG -> CGAAAGACCCTTCGTAAAGT
GCGACATCACGGGTAGGCTA -> CGACATCACGGGTAGGCTAG
GCGACTATCTTGAGCATAAA -> CGACTATCTTGAGCATAAAC
GCGACTTATCCGCACTGTGA -> CGACTTATCCGCACTGTGAT
GCGATAGAGTCGATGAGCCT -> CGATAGAGTCGATGAGCCTT
GCGATCAAGCATTACAGGAG -> CGATCAAGCATTACAGGAGA
GCGCAGAAATCTTAGCAGAC -> CGCAGAAATCTTAGCAGACT
GCGCCACGTCTGGAAGGGGG -> CGCCACGTCTGGAAGGGGGG
GCGGGATTGTTGAGGGTCCC -> CGGGATTGTTGAGGGTCCCG
GCGGTGCTATTTGGCCGGAA -> CGGTGCTATTTGGCCGGAAA
GCGTCGCCCATGGTTGTCAT -> CGTCGCCCATGGTTGTCATA
GCTACCTTACTGGTAATCTG -> CTACCTTACTGGTAATCTGG
GCTAGCGACTATCTTGAGCA -> CTAGCGACTATCTTGAGCAT
GCTATTCTAGGTGATTAAGT -> CTATTCTAGGTGATTAAGTA
GCTATTTGGCCGGAAAGTCC -> CTATTTGGCCGGAAAGTCCG
GCTCACAAGAGCGACATCAC -> CTCACAAGAGCGACATCACG
GCTGAAGCTTGGTGTTTTCA -> CTGAAGCTTGGTGTTTTCAT
GCTGGCAAGCAGGTGGCCGC -> CTGGCAAGCAGGTGGCCGCG
GCTGGGGCCAATCTCAATAG -> CTGGGGCCAATCTCAATAGG
GCTTCCTGTTTGCAAGATCA -> CTTCCTGTTTGCAAGATCAC
GCTTCGAGTCGAGGTTCGGA -> CTTCGAGTCGAGGTTCGGAA
GCTTGGGCCCTATACGCGAA -> CTTGGGCCCTATACGCGAAA
GCTTGGTGTTTTCATTGGAA -> CTTGGTGTTTTCATTGGAAT
GCTTTGGAGCGCCACGTCTG -> CTTTGGAGCGCCACGTCTGG
GCTTTGGGCGATAGAGTCGA -> CTTTGGGCGATAGAGTCGAT
GGAAACAATTCGTCAACTAT -> GAAACAATTCGTCAACTATG
GGAAAGTCCGTTAAGCTGGC -> GAAAGTCCGTTAAGCTGGCA
GGAAATACACCTCGCCTTTG -> GAAATACACCTCGCCTTTGT
GGAAGGGGGGATTGCCCAGT -> GAAGGGGGGATTGCCCAGTA
GGAAGTTATCAGACAGGTCT -> GAAGTTATCAGACAGGTCTT
GGAATGGTAAACAGGAGGAT -> GAATGGTAAACAGGAGGATT
GGACCCGATCTAGACGTTCT -> GACCCGATCTAGACGTTCTC
GGACCTATGTCATGCAGACC -> GACCTATGTCATGCAGACCA
GGACGGGAAGTTATCAGACA -> GACGGGAAGTTATCAGACAG
GGAGAAGCCTATCATGGTCG -> GAGAAGCCTATCATGGTCGC
GGAGCGCCACGTCTGGAAGG -> GAGCGCCACGTCTGGAAGGG
GGAGGATAGGTGGATACTGA -> GAGGATAGGTGGATACTGAT
GGAGGATTGGGTTATTAAAA -> GAGGATTGGGTTATTAAAAG
GGAGGCCAGTCTGAAATAGG -> GAGGCCAGTCTGAAATAGGA
GGATACTGATGGGTTTCCAC -> GATACTGATGGGTTTCCACG
GGATAGGTGGATACTGATGG -> GATAGGTGGATACTGATGGG
GGATTGCCCAGTATGCGGGA -> GATTGCCCAGTATGCGGGAT
GGATTGGGTTATTAAAAGGG -> GATTGGGTTATTAAAAGGGG
GGATTGTTGAGGGTCCCGCC -> GATTGTTGAGGGTCCCGCCC
GGCAAGCAGGTGGCCGCGAT -> GCAAGCAGGTGGCCGCGATC
GGCCAATCTCAATAGGAGGA -> GCCAATCTCAATAGGAGGAT
GGCCACGTTGCGCGAGAGCC -> GCCACGTTGCGCGAGAGCCT
GGCCAGTAGAAGAATAAGAC -> GCCAGTAGAAGAATAAGACG
GGCCAGTCTGAAATAGGACC -> GCCAGTCTGAAATAGGACCC
GGCCCTATACGCGAAAGACC -> GCCCTATACGCGAAAGACCC
GGCCGCGATCAAGCATTACA -> GCCGCGATCAAGCATTACAG
GGCCGGAAAGTCCGTTAAGC -> GCCGGAAAGTCCGTTAAGCT
GGCCTCTGGGGGTGCGACTT -> GCCTCTGGGGGTGCGACTTA
GGCGATAGAGTCGATGAGCC -> GCGATAGAGTCGATGAGCCT
GGCGCAGAAATCTTAGCAGA -> GCGCAGAAATCTTAGCAGAC
GGCGGTGCTATTTGGCCGGA -> GCGGTGCTATTTGGCCGGAA
GGCGTCGCCCATGGTTGTCA -> GCGTCGCCCATGGTTGTCAT
GGCTAGCGACTATCTTGAGC -> GCTAGCGACTATCTTGAGCA
GGCTGAAGCTTGGTGTTTTC -> GCTGAAGCTTGGTGTTTTCA
GGCTTGGGCCCTATACGCGA -> GCTTGGGCCCTATACGCGAA
GGGAAGTTATCAGACAGGTC -> GGAAGTTATCAGACAGGTCT
GGGAGGCCAGTCTGAAATAG -> GGAGGCCAGTCTGAAATAGG
GGGATTGCCCAGTATGCGGG -> GGATTGCCCAGTATGCGGGA
GGGATTGTTGAGGGTCCCGC -> GGATTGTTGAGGGTCCCGCC
GGGCCAATCTCAATAGGAGG -> GGCCAATCTCAATAGGAGGA
GGGCCAGTAGAAGAATAAGA -> GGCCAGTAGAAGAATAAGAC
GGGCCCTATACGCGAAAGAC -> GGCCCTATACGCGAAAGACC
GGGCGATAGAGTCGATGAGC -> GGCGATAGAGTCGATGAGCC
GGGCTGAAGCTTGGTGTTTT -> GGCTGAAGCTTGGTGTTTTC
GGGGAGGCCAGTCTGAAATA -> GGGAGGCCAGTCTGAAATAG
GGGGATTGCCCAGTATGCGG -> GGGATTGCCCAGTATGCGGG
GGGGCCAATCTCAATAGGAG -> GGGCCAATCTCAATAGGAGG
GGGGCTGAAGCTTGGTGTTT -> GGGCTGAAGCTTGGTGTTTT
GGGGGATTGCCCAGTATGCG -> GGGGATTGCCCAGTATGCGG
GGGGGGATTGCCCAGTATGC -> GGGGGATTGCCCAGTATGCG
GGGGGTGCGACTTATCCGCA -> GGGGTGCGACTTATCCGCAC
GGGGTGCGACTTATCCGCAC -> GGGTGCGACTTATCCGCACT
GGGTAGGCTAGCGACTATCT -> GGTAGGCTAGCGACTATCTT
GGGTCCCGCCCGCCCAACTT -> GGTCCCGCCCGCCCAACTTC
GGGTGCGACTTATCCGCACT -> GGTGCGACTTATCCGCACTG
GGGTTATTAAAAGGGGAGGC -> GGTTATTAAAAGGGGAGGCC
GGGTTTCCACGTCATGTTCA -> GGTTTCCACGTCATGTTCAA
GGTAAACAGGAGGATTGGGT -> GTAAACAGGAGGATTGGGTT
GGTAATCTGGAAACAATTCG -> GTAATCTGGAAACAATTCGT
GGTAGGCTAGCGACTATCTT -> GTAGGCTAGCGACTATCTTG
GGTCCCGCCCGCCCAACTTC -> GTCCCGCCCGCCCAACTTCA
GGTCGCTTTGGAGCGCCACG -> GTCGCTTTGGAGCGCCACGT
GGTCTTGAATTCGATAGTGC -> GTCTTGAATTCGATAGTGCC
GGTGAATGACTAAACACGGG -> GTGAATGACTAAACACGGGG
GGTGATTAAGTATACCCAAG -> GTGATTAAGTATACCCAAGG
GGTGCGACTTATCCGCACTG -> GTGCGACTTATCCGCACTGT
GGTGCTATTTGGCCGGAAAG -> GTGCTATTTGGCCGGAAAGT
GGTGGATACTGATGGGTTTC -> GTGGATACTGATGGGTTTCC
GGTGGCCGCGATCAAGCATT -> GTGGCCGCGATCAAGCATTA
GGTGTTACCCATCCCGGCGC -> GTGTTACCCATCCCGGCGCA
GGTGTTTTCATTGGAATGGT -> GTGTTTTCATTGGAATGGTA
GGTTATTAAAAGGGGAGGCC -> GTTATTAAAAGGGGAGGCCA
GGTTCGGAAATACACCTCGC -> GTTCGGAAATACACCTCGCC
GGTTGATAACCTTCTCAACA -> GTTGATAACCTTCTCAACAA
GGTTGTCATAAACGCAGGAC -> GTTGTCATAAACGCAGGACC
GGTTTCCACGTCATGTTCAA -> GTTTCCACGTCATGTTCAAC
GTAAACAGGAGGATTGGGTT -> TAAACAGGAGGATTGGGTTA
GTAAAGTCGCTACCTTACTG -> TAAAGTCGCTACCTTACTGG
GTAAGAGTGCCAGGTTGATA -> TAAGAGTGCCAGGTTGATAA
GTAAGTGGCGTCGCCCATGG -> TAAGTGGCGTCGCCCATGGT
GTAATCTGGAAACAATTCGT -> TAATCTGGAAACAATTCGTC
GTACTCTGAAGCTCACAAGA -> TACTCTGAAGCTCACAAGAG
GTAGAAGAATAAGACGGTGA -> TAGAAGAATAAGACGGTGAA
GTAGGCTAGCGACTATCTTG -> TAGGCTAGCGACTATCTTGA
GTATACCCAAGGACGGGAAG -> TATACCCAAGGACGGGAAGT
GTATATGACCTATCACCGAG -> TATATGACCTATCACCGAGT
GTATGCGGGATTGTTGAGGG -> TATGCGGGATTGTTGAGGGT
GTCAACTATGTAAGTGGCGT -> TCAACTATGTAAGTGGCGTC
GTCATAAACGCAGGACCTAT -> TCATAAACGCAGGACCTATG
GTCATGCAGACCAGCCCCAG -> TCATGCAGACCAGCCCCAGC
GTCATGTTCAACTTTCCCTC -> TCATGTTCAACTTTCCCTCG
GTCCCGCCCGCCCAACTTCA -> TCCCGCCCGCCCAACTTCAA
GTCCGTTAAGCTGGCAAGCA -> TCCGTTAAGCTGGCAAGCAG
GTCGAGGTTCGGAAATACAC -> TCGAGGTTCGGAAATACACC
GTCGATGAGCCTTGCTTCCT -> TCGATGAGCCTTGCTTCCTG
GTCGCCCATGGTTGTCATAA -> TCGCCCATGGTTGTCATAAA
GTCGCTACCTTACTGGTAAT -> TCGCTACCTTACTGGTAATC
GTCGCTTTGGAGCGCCACGT -> TCGCTTTGGAGCGCCACGTC
GTCTGAAATAGGACCCGATC -> TCTGAAATAGGACCCGATCT
GTCTGGAAGGGGGGATTGCC -> TCTGGAAGGGGGGATTGCCC
GTCTTGAATTCGATAGTGCC -> TCTTGAATTCGATAGTGCCA
GTGAATGACTAAACACGGGG -> TGAATGACTAAACACGGGGC
GTGATGCCTTGAAAAAAGAC -> TGATGCCTTGAAAAAAGACT
GTGATTAAGTATACCCAAGG -> TGATTAAGTATACCCAAGGA
GTGCCAGATTGAAATCCGTA -> TGCCAGATTGAAATCCGTAT
GTGCCAGGTTGATAACCTTC -> TGCCAGGTTGATAACCTTCT
GTGCGACTTATCCGCACTGT -> TGCGACTTATCCGCACTGTG
GTGCTATTTGGCCGGAAAGT -> TGCTATTTGGCCGGAAAGTC
GTGCTTTGGGCGATAGAGTC -> TGCTTTGGGCGATAGAGTCG
GTGGATACTGATGGGTTTCC -> TGGATACTGATGGGTTTCCA
GTGGCCGCGATCAAGCATTA -> TGGCCGCGATCAAGCATTAC
GTGGCGTCGCCCATGGTTGT -> TGGCGTCGCCCATGGTTGTC
GTGTTACCCATCCCGGCGCA -> TGTTACCCATCCCGGCGCAG
GTGTTTTCATTGGAATGGTA -> TGTTTTCATTGGAATGGTAA
GTTAAGCTGGCAAGCAGGTG -> TTAAGCTGGCAAGCAGGTGG
GTTACCCATCCCGGCGCAGA -> TTACCCATCCCGGCGCAGAA
GTTATCAGACAGGTCTTGAA -> TTATCAGACAGGTCTTGAAT
GTTATTAAAAGGGGAGGCCA -> TTATTAAAAGGGGAGGCCAG
GTTCAACTTTCCCTCGACGA -> TTCAACTTTCCCTCGACGAC
GTTCGGAAATACACCTCGCC -> TTCGGAAATACACCTCGCCT
GTTCTCTACACGAGCTGGGG -> TTCTCTACACGAGCTGGGGC
GTTGAGGGTCCCGCCCGCCC -> TTGAGGGTCCCGCCCGCCCA
GTTGATAACCTTCTCAACAA -> TTGATAACCTTCTCAACAAG
GTTGCGCGAGAGCCTGGTCT -> TTGCGCGAGAGCCTGGTCTT
GTTGTCATAAACGCAGGACC -> TTGTCATAAACGCAGGACCT
GTTTCCACGTCATGTTCAAC -> TTTCCACGTCATGTTCAACT
GTTTGCAAGATCACTTGCAT -> TTTGCAAGATCACTTGCATA
GTTTTCATTGGAATGGTAAA -> TTTTCATTGGAATGGTAAAC
TAAAAGGGGAGGCCAGTCTG -> AAAAGGGGAGGCCAGTCTGA
TAAACACGGGGCTGAAGCTT -> AAACACGGGGCTGAAGCTTG
TAAACAGGAGGATTGGGTTA -> AAACAGGAGGATTGGGTTAT
TAAACGCAGGACCTATGTCA -> AAACGCAGGACCTATGTCAT
TAAACTACCTAAGTGCTTTG -> AAACTACCTAAGTGCTTTGG
TAAAGTCGCTACCTTACTGG -> AAAGTCGCTACCTTACTGGT
TAACCTTCTCAACAAGGCGG -> AACCTTCTCAACAAGGCGGT
TAAGACGGTGAATGACTAAA -> AAGACGGTGAATGACTAAAC
TAAGAGTGCCAGGTTGATAA -> AAGAGTGCCAGGTTGATAAC
TAAGCTGGCAAGCAGGTGGC -> AAGCTGGCAAGCAGGTGGCC
TAAGTATACCCAAGGACGGG -> AAGTATACCCAAGGACGGGA
TAAGTGCTTTGGGCGATAGA -> AAGTGCTTTGGGCGATAGAG
TAAGTGGCGTCGCCCATGGT -> AAGTGGCGTCGCCCATGGTT
TAATCTGGAAACAATTCGTC -> AATCTGGAAACAATTCGTCA
TACACCTCGCCTTTGTAAGA -> ACACCTCGCCTTTGTAAGAG
TACACGAGCTGGGGCCAATC -> ACACGAGCTGGGGCCAATCT
TACACTGAAAAGATAGCTTC -> ACACTGAAAAGATAGCTTCG
TACAGGAGAAGCCTATCATG -> ACAGGAGAAGCCTATCATGG
TACCCAAGGACGGGAAGTTA -> ACCCAAGGACGGGAAGTTAT
TACCCATCCCGGCGCAGAAA -> ACCCATCCCGGCGCAGAAAT
TACCTAAGTGCTTTGGGCGA -> ACCTAAGTGCTTTGGGCGAT
TACCTTACTGGTAATCTGGA -> ACCTTACTGGTAATCTGGAA
TACGCGAAAGACCCTTCGTA -> ACGCGAAAGACCCTTCGTAA
TACTCTGAAGCTCACAAGAG -> ACTCTGAAGCTCACAAGAGC
TACTGATGGGTTTCCACGTC -> ACTGATGGGTTTCCACGTCA
TACTGGTAATCTGGAAACAA -> ACTGGTAATCTGGAAACAAT
TAGAAGAATAAGACGGTGAA -> AGAAGAATAAGACGGTGAAT
TAGACACCGGCTTGGGCCCT -> AGACACCGGCTTGGGCCCTA
TAGACGTTCTCTACACGAGC -> AGACGTTCTCTACACGAGCT
TAGAGTCGATGAGCCTTGCT -> AGAGTCGATGAGCCTTGCTT
TAGCAGACTATCACGATTAG -> AGCAGACTATCACGATTAGA
TAGCGACTATCTTGAGCATA -> AGCGACTATCTTGAGCATAA
TAGCTTCGAGTCGAGGTTCG -> AGCTTCGAGTCGAGGTTCGG
TAGGACCCGATCTAGACGTT -> AGGACCCGATCTAGACGTTC
TAGGAGGATAGGTGGATACT -> AGGAGGATAGGTGGATACTG
TAGGCTAGCGACTATCTTGA -> AGGCTAGCGACTATCTTGAG
TAGGTGATTAAGTATACCCA -> AGGTGATTAAGTATACCCAA
TAGGTGGATACTGATGGGTT -> AGGTGGATACTGATGGGTTT
TAGTGCCAGATTGAAATCCG -> AGTGCCAGATTGAAATCCGT
TATACCCAAGGACGGGAAGT -> ATACCCAAGGACGGGAAGTT
TATACGCGAAAGACCCTTCG -> ATACGCGAAAGACCCTTCGT
TATATGACCTATCACCGAGT -> ATATGACCTATCACCGAGTA
TATCACCGAGTACTCTGAAG -> ATCACCGAGTACTCTGAAGC
TATCACGATTAGACACCGGC -> ATCACGATTAGACACCGGCT
TATCAGACAGGTCTTGAATT -> ATCAGACAGGTCTTGAATTC
TATCATGGTCGCTTTGGAGC -> ATCATGGTCGCTTTGGAGCG
TATCCGCACTGTGATGCCTT -> ATCCGCACTGTGATGCCTTG
TATCCTTTTTTGGGCCAGTA -> ATCCTTTTTTGGGCCAGTAG
TATCTTGAGCATAAACTACC -> ATCTTGAGCATAAACTACCT
TATGACCTATCACCGAGTAC -> ATGACCTATCACCGAGTACT
TATGCGGGATTGTTGAGGGT -> ATGCGGGATTGTTGAGGGTC
TATGGCCACGTTGCGCGAGA -> ATGGCCACGTTGCGCGAGAG
TATGTAAGTGGCGTCGCCCA -> ATGTAAGTGGCGTCGCCCAT
TATGTCATGCAGACCAGCCC -> ATGTCATGCAGACCAGCCCC
TATTAAAAGGGGAGGCCAGT -> ATTAAAAGGGGAGGCCAGTC
TATTACACTGAAAAGATAGC -> ATTACACTGAAAAGATAGCT
TATTCTAGGTGATTAAGTAT -> ATTCTAGGTGATTAAGTATA
TATTTGGCCGGAAAGTCCGT -> ATTTGGCCGGAAAGTCCGTT
TCAACAAGGCGGTGCTATTT -> CAACAAGGCGGTGCTATTTG
TCAACTATGTAAGTGGCGTC -> CAACTATGTAAGTGGCGTCG
TCAACTTTCCCTCGACGACA -> CAACTTTCCCTCGACGACAA
TCAAGCATTACAGGAGAAGC -> CAAGCATTACAGGAGAAGCC
TCAAGCCGGCCTCTGGGGGT -> CAAGCCGGCCTCTGGGGGTG
TCAATAGGAGGATAGGTGGA -> CAATAGGAGGATAGGTGGAT
TCACAAGAGCGACATCACGG -> CACAAGAGCGACATCACGGG
TCACCGAGTACTCTGAAGCT -> CACCGAGTACTCTGAAGCTC
TCACGATTAGACACCGGCTT -> CACGATTAGACACCGGCTTG
TCACGGGTAGGCTAGCGACT -> CACGGGTAGGCTAGCGACTA
TCACTTGCATATCCTTTTTT -> CACTTGCATATCCTTTTTTG
TCAGACAGGTCTTGAATTCG -> CAGACAGGTCTTGAATTCGA
TCATAAACGCAGGACCTATG -> CATAAACGCAGGACCTATGT
TCATGCAGACCAGCCCCAGC -> CATGCAGACCAGCCCCAGCT
TCATGGTCGCTTTGGAGCGC -> CATGGTCGCTTTGGAGCGCC
TCATGTTCAACTTTCCCTCG -> CATGTTCAACTTTCCCTCGA
TCATTGGAATGGTAAACAGG -> CATTGGAATGGTAAACAGGA
TCCACGTCATGTTCAACTTT -> CCACGTCATGTTCAACTTTC
TCCCGAACTCTGGTGTTACC -> CCCGAACTCTGGTGTTACCC
TCCCGCCCGCCCAACTTCAA -> CCCGCCCGCCCAACTTCAAG
TCCCGGCGCAGAAATCTTAG -> CCCGGCGCAGAAATCTTAGC
TCCCTCGACGACAACAGACC -> CCCTCGACGACAACAGACCC
TCCGCACTGTGATGCCTTGA -> CCGCACTGTGATGCCTTGAA
TCCGTATATGACCTATCACC -> CCGTATATGACCTATCACCG
TCCGTTAAGCTGGCAAGCAG -> CCGTTAAGCTGGCAAGCAGG
TCCTGTTTGCAAGATCACTT -> CCTGTTTGCAAGATCACTTG
TCCTTTTTTGGGCCAGTAGA -> CCTTTTTTGGGCCAGTAGAA
TCGACGACAACAGACCCGAC -> CGACGACAACAGACCCGACT
TCGAGGTTCGGAAATACACC -> CGAGGTTCGGAAATACACCT
TCGAGTCGAGGTTCGGAAAT -> CGAGTCGAGGTTCGGAAATA
TCGATAGTGCCAGATTGAAA -> CGATAGTGCCAGATTGAAAT
TCGATGAGCCTTGCTTCCTG -> CGATGAGCCTTGCTTCCTGT
TCGCCCATGGTTGTCATAAA -> CGCCCATGGTTGTCATAAAC
TCGCCTTTGTAAGAGTGCCA -> CGCCTTTGTAAGAGTGCCAG
TCGCTACCTTACTGGTAATC -> CGCTACCTTACTGGTAATCT
TCGCTTTGGAGCGCCACGTC -> CGCTTTGGAGCGCCACGTCT
TCGGAAATACACCTCGCCTT -> CGGAAATACACCTCGCCTTT
TCGTAAAGTCGCTACCTTAC -> CGTAAAGTCGCTACCTTACT
TCGTCAACTATGTAAGTGGC -> CGTCAACTATGTAAGTGGCG
TCTACACGAGCTGGGGCCAA -> CTACACGAGCTGGGGCCAAT
TCTAGACGTTCTCTACACGA -> CTAGACGTTCTCTACACGAG
TCTAGGTGATTAAGTATACC -> CTAGGTGATTAAGTATACCC
TCTCAACAAGGCGGTGCTAT -> CTCAACAAGGCGGTGCTATT
TCTCAATAGGAGGATAGGTG -> CTCAATAGGAGGATAGGTGG
TCTCTACACGAGCTGGGGCC -> CTCTACACGAGCTGGGGCCA
TCTGAAATAGGACCCGATCT -> CTGAAATAGGACCCGATCTA
TCTGAAGCTCACAAGAGCGA -> CTGAAGCTCACAAGAGCGAC
TCTGGAAACAATTCGTCAAC -> CTGGAAACAATTCGTCAACT
TCTGGAAGGGGGGATTGCCC -> CTGGAAGGGGGGATTGCCCA
TCTGGGGGTGCGACTTATCC -> CTGGGGGTGCGACTTATCCG
TCTGGTGTTACCCATCCCGG -> CTGGTGTTACCCATCCCGGC
TCTTAGCAGACTATCACGAT -> CTTAGCAGACTATCACGATT
TCTTGAATTCGATAGTGCCA -> CTTGAATTCGATAGTGCCAG
TCTTGAGCATAAACTACCTA -> CTTGAGCATAAACTACCTAA
TGAAAAAAGACTCCCGAACT -> GAAAAAAGACTCCCGAACTC
TGAAAAGATAGCTTCGAGTC -> GAAAAGATAGCTTCGAGTCG
TGAAATAGGACCCGATCTAG -> GAAATAGGACCCGATCTAGA
TGAAATCCGTATATGACCTA -> GAAATCCGTATATGACCTAT
TGAAGCTCACAAGAGCGACA -> GAAGCTCACAAGAGCGACAT
TGAAGCTTGGTGTTTTCATT -> GAAGCTTGGTGTTTTCATTG
TGAATGACTAAACACGGGGC -> GAATGACTAAACACGGGGCT
TGAATTCGATAGTGCCAGAT -> GAATTCGATAGTGCCAGATT
TGACCTATCACCGAGTACTC -> GACCTATCACCGAGTACTCT
TGACTAAACACGGGGCTGAA -> GACTAAACACGGGGCTGAAG
TGAGCATAAACTACCTAAGT -> GAGCATAAACTACCTAAGTG
TGAGCCTTGCTTCCTGTTTG -> GAGCCTTGCTTCCTGTTTGC
TGAGGGTCCCGCCCGCCCAA -> GAGGGTCCCGCCCGCCCAAC
TGATAACCTTCTCAACAAGG -> GATAACCTTCTCAACAAGGC
TGATGCCTTGAAAAAAGACT -> GATGCCTTGAAAAAAGACTC
TGATGGGTTTCCACGTCATG -> GATGGGTTTCCACGTCATGT
TGATTAAGTATACCCAAGGA -> GATTAAGTATACCCAAGGAC
TGCAAGATCACTTGCATATC -> GCAAGATCACTTGCATATCC
TGCAGACCAGCCCCAGCTAT -> GCAGACCAGCCCCAGCTATT
TGCATATCCTTTTTTGGGCC -> GCATATCCTTTTTTGGGCCA
TGCCAGATTGAAATCCGTAT -> GCCAGATTGAAATCCGTATA
TGCCAGGTTGATAACCTTCT -> GCCAGGTTGATAACCTTCTC
TGCCCAGTATGCGGGATTGT -> GCCCAGTATGCGGGATTGTT
TGCCTTGAAAAAAGACTCCC -> GCCTTGAAAAAAGACTCCCG
TGCGACTTATCCGCACTGTG -> GCGACTTATCCGCACTGTGA
TGCGGGATTGTTGAGGGTCC -> GCGGGATTGTTGAGGGTCCC
TGCTATTTGGCCGGAAAGTC -> GCTATTTGGCCGGAAAGTCC
TGCTTCCTGTTTGCAAGATC -> GCTTCCTGTTTGCAAGATCA
TGCTTTGGGCGATAGAGTCG -> GCTTTGGGCGATAGAGTCGA
TGGAAACAATTCGTCAACTA -> GGAAACAATTCGTCAACTAT
TGGAAGGGGGGATTGCCCAG -> GGAAGGGGGGATTGCCCAGT
TGGAATGGTAAACAGGAGGA -> GGAATGGTAAACAGGAGGAT
TGGAGCGCCACGTCTGGAAG -> GGAGCGCCACGTCTGGAAGG
TGGATACTGATGGGTTTCCA -> GGATACTGATGGGTTTCCAC
TGGCAAGCAGGTGGCCGCGA -> GGCAAGCAGGTGGCCGCGAT
TGGCCACGTTGCGCGAGAGC -> GGCCACGTTGCGCGAGAGCC
TGGCCGCGATCAAGCATTAC -> GGCCGCGATCAAGCATTACA
TGGCCGGAAAGTCCGTTAAG -> GGCCGGAAAGTCCGTTAAGC
TGGCGTCGCCCATGGTTGTC -> GGCGTCGCCCATGGTTGTCA
TGGGCCAGTAGAAGAATAAG -> GGGCCAGTAGAAGAATAAGA
TGGGCCCTATACGCGAAAGA -> GGGCCCTATACGCGAAAGAC
TGGGCGATAGAGTCGATGAG -> GGGCGATAGAGTCGATGAGC
TGGGGCCAATCTCAATAGGA -> GGGGCCAATCTCAATAGGAG
TGGGGGTGCGACTTATCCGC -> GGGGGTGCGACTTATCCGCA
TGGGTTATTAAAAGGGGAGG -> GGGTTATTAAAAGGGGAGGC
TGGGTTTCCACGTCATGTTC -> GGGTTTCCACGTCATGTTCA
TGGTAAACAGGAGGATTGGG -> GGTAAACAGGAGGATTGGGT
TGGTAATCTGGAAACAATTC -> GGTAATCTGGAAACAATTCG
TGGTCGCTTTGGAGCGCCAC -> GGTCGCTTTGGAGCGCCACG
TGGTGTTACCCATCCCGGCG -> GGTGTTACCCATCCCGGCGC
TGGTGTTTTCATTGGAATGG -> GGTGTTTTCATTGGAATGGT
TGGTTGTCATAAACGCAGGA -> GGTTGTCATAAACGCAGGAC
TGTAAGAGTGCCAGGTTGAT -> GTAAGAGTGCCAGGTTGATA
TGTAAGTGGCGTCGCCCATG -> GTAAGTGGCGTCGCCCATGG
TGTCATAAACGCAGGACCTA -> GTCATAAACGCAGGACCTAT
TGTCATGCAGACCAGCCCCA -> GTCATGCAGACCAGCCCCAG
TGTGATGCCTTGAAAAAAGA -> GTGATGCCTTGAAAAAAGAC
TGTTACCCATCCCGGCGCAG -> GTTACCCATCCCGGCGCAGA
TGTTCAACTTTCCCTCGACG -> GTTCAACTTTCCCTCGACGA
TGTTGAGGGTCCCGCCCGCC -> GTTGAGGGTCCCGCCCGCCC
TGTTTGCAAGATCACTTGCA -> GTTTGCAAGATCACTTGCAT
TGTTTTCATTGGAATGGTAA -> GTTTTCATTGGAATGGTAAA
TTAAAAGGGGAGGCCAGTCT -> TAAAAGGGGAGGCCAGTCTG
TTAAGCTGGCAAGCAGGTGG -> TAAGCTGGCAAGCAGGTGGC
TTAAGTATACCCAAGGACGG -> TAAGTATACCCAAGGACGGG
TTACACTGAAAAGATAGCTT -> TACACTGAAAAGATAGCTTC
TTACAGGAGAAGCCTATCAT -> TACAGGAGAAGCCTATCATG
TTACCCATCCCGGCGCAGAA -> TACCCATCCCGGCGCAGAAA
TTACTGGTAATCTGGAAACA -> TACTGGTAATCTGGAAACAA
TTAGACACCGGCTTGGGCCC -> TAGACACCGGCTTGGGCCCT
TTAGCAGACTATCACGATTA -> TAGCAGACTATCACGATTAG
TTATCAGACAGGTCTTGAAT -> TATCAGACAGGTCTTGAATT
TTATCCGCACTGTGATGCCT -> TATCCGCACTGTGATGCCTT
TTATTAAAAGGGGAGGCCAG -> TATTAAAAGGGGAGGCCAGT
TTCAACTTTCCCTCGACGAC -> TCAACTTTCCCTCGACGACA
TTCAAGCCGGCCTCTGGGGG -> TCAAGCCGGCCTCTGGGGGT
TTCATTGGAATGGTAAACAG -> TCATTGGAATGGTAAACAGG
TTCCACGTCATGTTCAACTT -> TCCACGTCATGTTCAACTTT
TTCCCTCGACGACAACAGAC -> TCCCTCGACGACAACAGACC
TTCCTGTTTGCAAGATCACT -> TCCTGTTTGCAAGATCACTT
TTCGAGTCGAGGTTCGGAAA -> TCGAGTCGAGGTTCGGAAAT
TTCGATAGTGCCAGATTGAA -> TCGATAGTGCCAGATTGAAA
TTCGGAAATACACCTCGCCT -> TCGGAAATACACCTCGCCTT
TTCGTAAAGTCGCTACCTTA -> TCGTAAAGTCGCTACCTTAC
TTCGTCAACTATGTAAGTGG -> TCGTCAACTATGTAAGTGGC
TTCTAGGTGATTAAGTATAC -> TCTAGGTGATTAAGTATACC
TTCTCAACAAGGCGGTGCTA -> TCTCAACAAGGCGGTGCTAT
TTCTCTACACGAGCTGGGGC -> TCTCTACACGAGCTGGGGCC
TTGAAAAAAGACTCCCGAAC -> TGAAAAAAGACTCCCGAACT
TTGAAATCCGTATATGACCT -> TGAAATCCGTATATGACCTA
TTGAATTCGATAGTGCCAGA -> TGAATTCGATAGTGCCAGAT
TTGAGCATAAACTACCTAAG -> TGAGCATAAACTACCTAAGT
TTGAGGGTCCCGCCCGCCCA -> TGAGGGTCCCGCCCGCCCAA
TTGATAACCTTCTCAACAAG -> TGATAACCTTCTCAACAAGG
TTGCAAGATCACTTGCATAT -> TGCAAGATCACTTGCATATC
TTGCATATCCTTTTTTGGGC -> TGCATATCCTTTTTTGGGCC
TTGCCCAGTATGCGGGATTG -> TGCCCAGTATGCGGGATTGT
TTGCTTCCTGTTTGCAAGAT -> TGCTTCCTGTTTGCAAGATC
TTGGAATGGTAAACAGGAGG -> TGGAATGGTAAACAGGAGGA
TTGGAGCGCCACGTCTGGAA -> TGGAGCGCCACGTCTGGAAG
TTGGCCGGAAAGTCCGTTAA -> TGGCCGGAAAGTCCGTTAAG
TTGGGCCAGTAGAAGAATAA -> TGGGCCAGTAGAAGAATAAG
TTGGGCCCTATACGCGAAAG -> TGGGCCCTATACGCGAAAGA
TTGGGCGATAGAGTCGATGA -> TGGGCGATAGAGTCGATGAG
TTGGGTTATTAAAAGGGGAG -> TGGGTTATTAAAAGGGGAGG
TTGGTGTTTTCATTGGAATG -> TGGTGTTTTCATTGGAATGG
TTGTAAGAGTGCCAGGTTGA -> TGTAAGAGTGCCAGGTTGAT
TTGTCATAAACGCAGGACCT -> TGTCATAAACGCAGGACCTA
TTGTTGAGGGTCCCGCCCGC -> TGTTGAGGGTCCCGCCCGCC
TTTCATTGGAATGGTAAACA -> TTCATTGGAATGGTAAACAG
TTTCCACGTCATGTTCAACT -> TTCCACGTCATGTTCAACTT
TTTCCCTCGACGACAACAGA -> TTCCCTCGACGACAACAGAC
TTTGCAAGATCACTTGCATA -> TTGCAAGATCACTTGCATAT
TTTGGAGCGCCACGTCTGGA -> TTGGAGCGCCACGTCTGGAA
TTTGGCCGGAAAGTCCGTTA -> TTGGCCGGAAAGTCCGTTAA
TTTGGGCCAGTAGAAGAATA -> TTGGGCCAGTAGAAGAATAA
TTTGGGCGATAGAGTCGATG -> TTGGGCGATAGAGTCGATGA
TTTGTAAGAGTGCCAGGTTG -> TTGTAAGAGTGCCAGGTTGA
TTTTCATTGGAATGGTAAAC -> TTTCATTGGAATGGTAAACA
TTTTGGGCCAGTAGAAGAAT -> TTTGGGCCAGTAGAAGAATA
TTTTTGGGCCAGTAGAAGAA -> TTTTGGGCCAGTAGAAGAAT
TTTTTTGGGCCAGTAGAAGA -> TTTTTGGGCCAGTAGAAGAA
