AAAAAAATAACATCAGTAC -> AAAAAATAACATCAGTACC
AAAAAATAACATCAGTACC -> AAAAATAACATCAGTACCG
AAAAACCGCCTCCACAGTG -> AAAACCGCCTCCACAGTGA
AAAAATAACATCAGTACCG -> AAAATAACATCAGTACCGA
AAAACCGCCTCCACAGTGA -> AAACCGCCTCCACAGTGAT
AAAACGACGAGAGCTCAAC -> AAACGACGAGAGCTCAACC
AAAACGCTGCAACCAGGAT -> AAACGCTGCAACCAGGATG
AAAACTCCTGTCCTCGGGT -> AAACTCCTGTCCTCGGGTT
AAAATAACATCAGTACCGA -> AAATAACATCAGTACCGAC
AAAATACCGCCCAGAATTT -> AAATACCGCCCAGAATTTC
AAAATGAGACCAGGGCTAA -> AAATGAGACCAGGGCTAAT
AAAATGTACAGCCTGTCTA -> AAATGTACAGCCTGTCTAG
AAACATAAAGCTGGAACGC -> AACATAAAGCTGGAACGCT
AAACCGCCTCCACAGTGAT -> AACCGCCTCCACAGTGATT
AAACCGCGCGGTTTCAATC -> AACCGCGCGGTTTCAATCC
AAACGACGAGAGCTCAACC -> AACGACGAGAGCTCAACCC
AAACGCTGCAACCAGGATG -> AACGCTGCAACCAGGATGG
AAACGGGTTACCGACCCGG -> AACGGGTTACCGACCCGGT
AAACTAATTGGACCAGTTC -> AACTAATTGGACCAGTTCA
AAACTCCTGTCCTCGGGTT -> AACTCCTGTCCTCGGGTTA
AAACTTTTTGATAAGTTGT -> AACTTTTTGATAAGTTGTC
AAAGCCGCAACCATAGTGT -> AAGCCGCAACCATAGTGTC
AAAGCGTATGTAATTGAAC -> AAGCGTATGTAATTGAACA
AAAGCGTATGTCCACTCAC -> AAGCGTATGTCCACTCACA
AAAGCGTATGTCTTCGCAG -> AAGCGTATGTCTTCGCAGG
AAAGCGTATGTGACATAAT -> AAGCGTATGTGACATAATA
AAAGCTGGAACGCTACGGG -> AAGCTGGAACGCTACGGGT
AAAGGACATCCAAATACCG -> AAGGACATCCAAATACCGA
AAAGGCTAGAACAACAACG -> AAGGCTAGAACAACAACGC
AAAGGTTCGCCACACTTCC -> AAGGTTCGCCACACTTCCG
AAATAACATCAGTACCGAC -> AATAACATCAGTACCGACC
AAATACCGAGCCAATATTG -> AATACCGAGCCAATATTGA
AAATACCGCCCAGAATTTC -> AATACCGCCCAGAATTTCG
AAATAGAGCTACTACGCTA -> AATAGAGCTACTACGCTAA
AAATCGAGCACCTCGGTGA -> AATCGAGCACCTCGGTGAT
AAATGAGACCAGGGCTAAT -> AATGAGACCAGGGCTAATA
AAATGTACAGCCTGTCTAG -> AATGTACAGCCTGTCTAGT
AAATGTATAAAGGTTCGCC -> AATGTATAAAGGTTCGCCA
AACAACAACGCCCTGCGGA -> ACAACAACGCCCTGCGGAG
AACAACAGACGTCACTAGA -> ACAACAGACGTCACTAGAC
AACAACGCCCTGCGGAGGT -> ACAACGCCCTGCGGAGGTG
AACAAGTGACGTCGAAGAG -> ACAAGTGACGTCGAAGAGA
AACACAGGCGGAGCTAGAG -> ACACAGGCGGAGCTAGAGC
AACACGGAAGGAATGCCGC -> ACACGGAAGGAATGCCGCA
AACAGACGTCACTAGACTG -> ACAGACGTCACTAGACTGC
AACATAAAGCTGGAACGCT -> ACATAAAGCTGGAACGCTA
AACATATTCATACACCGAG -> ACATATTCATACACCGAGC
AACATCAGTACCGACCCAT -> ACATCAGTACCGACCCATA
AACATCTTGATCAATCGAT -> ACATCTTGATCAATCGATA
AACCAGGATGGCTCGGTTG -> ACCAGGATGGCTCGGTTGG
AACCATAGTGTCGTGGTAC -> ACCATAGTGTCGTGGTACC
AACCATGAAGTTAACATCT -> ACCATGAAGTTAACATCTT
AACCCCCATAGAGCACGCG -> ACCCCCATAGAGCACGCGC
AACCCCGACTGAAGGGATG -> ACCCCGACTGAAGGGATGA
AACCCGGGCAGTTCAGGCT -> ACCCGGGCAGTTCAGGCTA
AACCGATATCTGTACGGTA -> ACCGATATCTGTACGGTAA
AACCGCCTCCACAGTGATT -> ACCGCCTCCACAGTGATTG
AACCGCGCGGTTTCAATCC -> ACCGCGCGGTTTCAATCCT
AACCTCGCCCCGAGTTGAA -> ACCTCGCCCCGAGTTGAAC
AACCTCTGGCCTTTAGAGT -> ACCTCTGGCCTTTAGAGTC
AACCTGAGTTCGGACCGCT -> ACCTGAGTTCGGACCGCTA
AACCTTCCCCGTTCCCAAT -> ACCTTCCCCGTTCCCAATA
AACCTTTTGGGTTTTAGGT -> ACCTTTTGGGTTTTAGGTT
AACGACGAGAGCTCAACCC -> ACGACGAGAGCTCAACCCG
AACGACTCTTATTTGAAGA -> ACGACTCTTATTTGAAGAC
AACGCCCTGCGGAGGTGCG -> ACGCCCTGCGGAGGTGCGC
AACGCTACGGGTGTTGTAC -> ACGCTACGGGTGTTGTACC
AACGCTGCAACCAGGATGG -> ACGCTGCAACCAGGATGGC
AACGGGTGCGATGATGGGT -> ACGGGTGCGATGATGGGTC
AACGGGTTACCGACCCGGT -> ACGGGTTACCGACCCGGTG
AACGTGTTCACGCATTGAT -> ACGTGTTCACGCATTGATA
AACGTTGTTCTTTATTGGT -> ACGTTGTTCTTTATTGGTA
AACTAATTGGACCAGTTCA -> ACTAATTGGACCAGTTCAT
AACTATTCCAACCTTCCCC -> ACTATTCCAACCTTCCCCG
AACTCCTGTCCTCGGGTTA -> ACTCCTGTCCTCGGGTTAC
AACTCGAATCCCCTTTCCT -> ACTCGAATCCCCTTTCCTA
AACTTCACTCAGCTATAAG -> ACTTCACTCAGCTATAAGA
AACTTTTTGATAAGTTGTC -> ACTTTTTGATAAGTTGTCA
AAGACAGGGATAAGCAGCA -> AGACAGGGATAAGCAGCAT
AAGAGAAAAACCGCCTCCA -> AGAGAAAAACCGCCTCCAC
AAGAGGAAGGCCAAACTTT -> AGAGGAAGGCCAAACTTTT
AAGAGTATTTCATAGCTAC -> AGAGTATTTCATAGCTACG
AAGATAAGTTCAAGTCCTG -> AGATAAGTTCAAGTCCTGA
AAGATGTATAACCTCTGGC -> AGATGTATAACCTCTGGCC
AAGATGTCTGTCGCTCCCA -> AGATGTCTGTCGCTCCCAT
AAGCAAAATGAGACCAGGG -> AGCAAAATGAGACCAGGGC
AAGCAGCATGTTTCATCTA -> AGCAGCATGTTTCATCTAA
AAGCCCAACGGGTGCGATG -> AGCCCAACGGGTGCGATGA
AAGCCGACCAAAGCGTATG -> AGCCGACCAAAGCGTATGT
AAGCCGCAACCATAGTGTC -> AGCCGCAACCATAGTGTCG
AAGCGTATGTAATTGAACA -> AGCGTATGTAATTGAACAT
AAGCGTATGTCCACTCACA -> AGCGTATGTCCACTCACAA
AAGCGTATGTCTTCGCAGG -> AGCGTATGTCTTCGCAGGG
AAGCGTATGTGACATAATA -> AGCGTATGTGACATAATAT
AAGCTCCGGAGGGTCCGTT -> AGCTCCGGAGGGTCCGTTG
AAGCTGAATGTCGATAACC -> AGCTGAATGTCGATAACCG
AAGCTGGAACGCTACGGGT -> AGCTGGAACGCTACGGGTG
AAGGAATGCCGCACAACCT -> AGGAATGCCGCACAACCTC
AAGGACATCCAAATACCGA -> AGGACATCCAAATACCGAG
AAGGCCAAACTTTTTGATA -> AGGCCAAACTTTTTGATAA
AAGGCTAGAACAACAACGC -> AGGCTAGAACAACAACGCC
AAGGGATGAGGCACTGTAC -> AGGGATGAGGCACTGTACG
AAGGTTCGCCACACTTCCG -> AGGTTCGCCACACTTCCGA
AAGTCATAGAGCTCCAACC -> AGTCATAGAGCTCCAACCC
AAGTCCTGACCCCCTTACA -> AGTCCTGACCCCCTTACAA
AAGTCGAATCGACTTAATG -> AGTCGAATCGACTTAATGA
AAGTGACGTCGAAGAGAAA -> AGTGACGTCGAAGAGAAAA
AAGTGCATTGCGTTGTCAC -> AGTGCATTGCGTTGTCACC
AAGTTAACATCTTGATCAA -> AGTTAACATCTTGATCAAT
AAGTTCAAGTCCTGACCCC -> AGTTCAAGTCCTGACCCCC
AAGTTGTCATATTACATAC -> AGTTGTCATATTACATACA
AATAACATCAGTACCGACC -> ATAACATCAGTACCGACCC
AATACAGCAGACCCCACAC -> ATACAGCAGACCCCACACG
AATACCGAGCCAATATTGA -> ATACCGAGCCAATATTGAG
AATACCGCCCAGAATTTCG -> ATACCGCCCAGAATTTCGA
AATACGGTAAATAGAGCTA -> ATACGGTAAATAGAGCTAC
AATAGAGCTACTACGCTAA -> ATAGAGCTACTACGCTAAA
AATAGGGCCTGGGAGTGCG -> ATAGGGCCTGGGAGTGCGT
AATATAGCCATCTAAGCTG -> ATATAGCCATCTAAGCTGA
AATATTGAGGATGCACCAT -> ATATTGAGGATGCACCATG
AATCCCCTTTCCTATTTGG -> ATCCCCTTTCCTATTTGGA
AATCCTAGTGACACAAAAC -> ATCCTAGTGACACAAAACG
AATCGACTTAATGAGGTTG -> ATCGACTTAATGAGGTTGG
AATCGAGCACCTCGGTGAT -> ATCGAGCACCTCGGTGATC
AATCGATACGATGGTCTAC -> ATCGATACGATGGTCTACA
AATCGCGCGTATATGATGG -> ATCGCGCGTATATGATGGC
AATGACCAGAGAAGCCGAC -> ATGACCAGAGAAGCCGACC
AATGAGACCAGGGCTAATA -> ATGAGACCAGGGCTAATAC
AATGAGGTTGGGATGGATT -> ATGAGGTTGGGATGGATTG
AATGCCGCACAACCTCGCC -> ATGCCGCACAACCTCGCCC
AATGGGGTTGTTCGTTTGT -> ATGGGGTTGTTCGTTTGTA
AATGTACAGCCTGTCTAGT -> ATGTACAGCCTGTCTAGTG
AATGTATAAAGGTTCGCCA -> ATGTATAAAGGTTCGCCAC
AATGTCGATAACCGATATC -> ATGTCGATAACCGATATCT
AATGTCGGATATGAGCGTC -> ATGTCGGATATGAGCGTCA
AATTCGGTGACTCTCTGGA -> ATTCGGTGACTCTCTGGAG
AATTCGTTACCAAAAAAAT -> ATTCGTTACCAAAAAAATA
AATTGAACATATTCATACA -> ATTGAACATATTCATACAC
AATTGGACCAGTTCATGGA -> ATTGGACCAGTTCATGGAA
AATTGTGCAATGACCAGAG -> ATTGTGCAATGACCAGAGA
AATTGTGCACCGTAGCATG -> ATTGTGCACCGTAGCATGT
AATTGTGCAGGCTGTGACG -> ATTGTGCAGGCTGTGACGG
AATTGTGCATACGACGACC -> ATTGTGCATACGACGACCT
AATTTCGAGTGGCAAAGGA -> ATTTCGAGTGGCAAAGGAC
ACAAAACGACGAGAGCTCA -> CAAAACGACGAGAGCTCAA
ACAACAACGCCCTGCGGAG -> CAACAACGCCCTGCGGAGG
ACAACAGACGTCACTAGAC -> CAACAGACGTCACTAGACT
ACAACCTCGCCCCGAGTTG -> CAACCTCGCCCCGAGTTGA
ACAACGCCCTGCGGAGGTG -> CAACGCCCTGCGGAGGTGC
ACAACGTGTTCACGCATTG -> CAACGTGTTCACGCATTGA
ACAACTTCACTCAGCTATA -> CAACTTCACTCAGCTATAA
ACAAGATAAGTTCAAGTCC -> CAAGATAAGTTCAAGTCCT
ACAAGTGACGTCGAAGAGA -> CAAGTGACGTCGAAGAGAA
ACAATAGGGCCTGGGAGTG -> CAATAGGGCCTGGGAGTGC
ACAATCGCGCGTATATGAT -> CAATCGCGCGTATATGATG
ACAATGGGGTTGTTCGTTT -> CAATGGGGTTGTTCGTTTG
ACAATGTCGGATATGAGCG -> CAATGTCGGATATGAGCGT
ACACAAAACGACGAGAGCT -> CACAAAACGACGAGAGCTC
ACACAGGCGGAGCTAGAGC -> CACAGGCGGAGCTAGAGCC
ACACCGAGCTATTTTAACT -> CACCGAGCTATTTTAACTC
ACACGGAAGGAATGCCGCA -> CACGGAAGGAATGCCGCAC
ACACGTTACTCGTGTACGA -> CACGTTACTCGTGTACGAG
ACACTTCCGAGTTTTCGAG -> CACTTCCGAGTTTTCGAGA
ACAGAAATGTATAAAGGTT -> CAGAAATGTATAAAGGTTC
ACAGACGTCACTAGACTGC -> CAGACGTCACTAGACTGCG
ACAGCAGACCCCACACGTT -> CAGCAGACCCCACACGTTA
ACAGCCTGTCTAGTGACGT -> CAGCCTGTCTAGTGACGTG
ACAGGCGGAGCTAGAGCCT -> CAGGCGGAGCTAGAGCCTC
ACAGGGATAAGCAGCATGT -> CAGGGATAAGCAGCATGTT
ACAGGTCTCTGGAGACGCT -> CAGGTCTCTGGAGACGCTG
ACAGTGATTGATACTTAGG -> CAGTGATTGATACTTAGGC
ACAGTTATACCAGGTCCTA -> CAGTTATACCAGGTCCTAG
ACATAAAGCTGGAACGCTA -> CATAAAGCTGGAACGCTAC
ACATAATATAGCCATCTAA -> CATAATATAGCCATCTAAG
ACATACAACGTGTTCACGC -> CATACAACGTGTTCACGCA
ACATACCGCTCATCGGTCC -> CATACCGCTCATCGGTCCT
ACATATTCATACACCGAGC -> CATATTCATACACCGAGCT
ACATCAGTACCGACCCATA -> CATCAGTACCGACCCATAA
ACATCCAAATACCGAGCCA -> CATCCAAATACCGAGCCAA
ACATCTTGATCAATCGATA -> CATCTTGATCAATCGATAC
ACCAAAAAAATAACATCAG -> CCAAAAAAATAACATCAGT
ACCAAAGCGTATGTAATTG -> CCAAAGCGTATGTAATTGA
ACCAAAGCGTATGTCCACT -> CCAAAGCGTATGTCCACTC
ACCAAAGCGTATGTCTTCG -> CCAAAGCGTATGTCTTCGC
ACCAAAGCGTATGTGACAT -> CCAAAGCGTATGTGACATA
ACCAGAGAAGCCGACCAAA -> CCAGAGAAGCCGACCAAAG
ACCAGGATGGCTCGGTTGG -> CCAGGATGGCTCGGTTGGA
ACCAGGGCTAATACAGCAG -> CCAGGGCTAATACAGCAGA
ACCAGGTCCTAGAAGCAAA -> CCAGGTCCTAGAAGCAAAA
ACCAGTTCATGGAAGAGGA -> CCAGTTCATGGAAGAGGAA
ACCATAGTGTCGTGGTACC -> CCATAGTGTCGTGGTACCC
ACCATGAAGTTAACATCTT -> CCATGAAGTTAACATCTTG
ACCATGTGGGGCAACGTTG -> CCATGTGGGGCAACGTTGT
ACCCATAAAACTCCTGTCC -> CCCATAAAACTCCTGTCCT
ACCCCACACGTTACTCGTG -> CCCCACACGTTACTCGTGT
ACCCCCATAGAGCACGCGC -> CCCCCATAGAGCACGCGCG
ACCCCCTTACAATGTCGGA -> CCCCCTTACAATGTCGGAT
ACCCCGACTGAAGGGATGA -> CCCCGACTGAAGGGATGAG
ACCCGACCGGCGAACCTTT -> CCCGACCGGCGAACCTTTT
ACCCGACGGATTAGCCGGT -> CCCGACGGATTAGCCGGTG
ACCCGGGCAGTTCAGGCTA -> CCCGGGCAGTTCAGGCTAA
ACCCGGTGATGGCTATCGT -> CCCGGTGATGGCTATCGTA
ACCCTATTAGTATATCCCG -> CCCTATTAGTATATCCCGG
ACCGACAGTTATACCAGGT -> CCGACAGTTATACCAGGTC
ACCGACCCATAAAACTCCT -> CCGACCCATAAAACTCCTG
ACCGACCCGGTGATGGCTA -> CCGACCCGGTGATGGCTAT
ACCGAGCCAATATTGAGGA -> CCGAGCCAATATTGAGGAT
ACCGAGCTATTTTAACTCG -> CCGAGCTATTTTAACTCGA
ACCGATAGACAAGATAAGT -> CCGATAGACAAGATAAGTT
ACCGATATCTGTACGGTAA -> CCGATATCTGTACGGTAAT
ACCGATGAGTGCAACAACA -> CCGATGAGTGCAACAACAG
ACCGCAGTCGTAAACCGCG -> CCGCAGTCGTAAACCGCGC
ACCGCCCAGAATTTCGAGT -> CCGCCCAGAATTTCGAGTG
ACCGCCTCCACAGTGATTG -> CCGCCTCCACAGTGATTGA
ACCGCGCAGCAGGAGCTGT -> CCGCGCAGCAGGAGCTGTC
ACCGCGCGGTTTCAATCCT -> CCGCGCGGTTTCAATCCTA
ACCGCTATATTTGACCGCG -> CCGCTATATTTGACCGCGC
ACCGCTCATCGGTCCTGAT -> CCGCTCATCGGTCCTGATT
ACCGGCGAACCTTTTGGGT -> CCGGCGAACCTTTTGGGTT
ACCGTAGCATGTAGCCGAC -> CCGTAGCATGTAGCCGACC
ACCTAGCCGACCAAAGCGT -> CCTAGCCGACCAAAGCGTA
ACCTATCGTCACTGCCAGT -> CCTATCGTCACTGCCAGTA
ACCTCGCCCCGAGTTGAAC -> CCTCGCCCCGAGTTGAACA
ACCTCGGTGATCGGTCCGG -> CCTCGGTGATCGGTCCGGG
ACCTCTGGCCTTTAGAGTC -> CCTCTGGCCTTTAGAGTCC
ACCTGAATTCGGTGACTCT -> CCTGAATTCGGTGACTCTC
ACCTGAGTTCGGACCGCTA -> CCTGAGTTCGGACCGCTAT
ACCTGGCTGGGCATGAAGC -> CCTGGCTGGGCATGAAGCC
ACCTTCCCCGTTCCCAATA -> CCTTCCCCGTTCCCAATAC
ACCTTTTGGGTTTTAGGTT -> CCTTTTGGGTTTTAGGTTG
ACGACCTAGCCGACCAAAG -> CGACCTAGCCGACCAAAGC
ACGACGACCTAGCCGACCA -> CGACGACCTAGCCGACCAA
ACGACGAGAGCTCAACCCG -> CGACGAGAGCTCAACCCGG
ACGACTCTTATTTGAAGAC -> CGACTCTTATTTGAAGACA
ACGAGAGATTTTATACTGG -> CGAGAGATTTTATACTGGT
ACGAGAGCTCAACCCGGGC -> CGAGAGCTCAACCCGGGCA
ACGATGGTCTACAGAAATG -> CGATGGTCTACAGAAATGT
ACGATTTGAACCCCGACTG -> CGATTTGAACCCCGACTGA
ACGCACGTCAGAGGTAGGG -> CGCACGTCAGAGGTAGGGA
ACGCATTGATAAATCGAGC -> CGCATTGATAAATCGAGCA
ACGCCCGGGACTGCTGACG -> CGCCCGGGACTGCTGACGC
ACGCCCTGCGGAGGTGCGC -> CGCCCTGCGGAGGTGCGCG
ACGCCGATATAACTATTCC -> CGCCGATATAACTATTCCA
ACGCCGTGTTTATAATTCG -> CGCCGTGTTTATAATTCGT
ACGCGCGACCCTATTAGTA -> CGCGCGACCCTATTAGTAT
ACGCTAAAACGCTGCAACC -> CGCTAAAACGCTGCAACCA
ACGCTACGGGTGTTGTACC -> CGCTACGGGTGTTGTACCC
ACGCTGCAACCAGGATGGC -> CGCTGCAACCAGGATGGCT
ACGCTGGCCCTGTACGGTA -> CGCTGGCCCTGTACGGTAA
ACGGAAGGAATGCCGCACA -> CGGAAGGAATGCCGCACAA
ACGGAGCCGACCAAAGCGT -> CGGAGCCGACCAAAGCGTA
ACGGATTAGCCGGTGAGTA -> CGGATTAGCCGGTGAGTAG
ACGGCTGTCCCCACCTATC -> CGGCTGTCCCCACCTATCG
ACGGGTGCGATGATGGGTC -> CGGGTGCGATGATGGGTCA
ACGGGTGTTGTACCCGACG -> CGGGTGTTGTACCCGACGG
ACGGGTTACCGACCCGGTG -> CGGGTTACCGACCCGGTGA
ACGGTAAATAGAGCTACTA -> CGGTAAATAGAGCTACTAC
ACGGTAATTGTGCAATGAC -> CGGTAATTGTGCAATGACC
ACGGTAATTGTGCACCGTA -> CGGTAATTGTGCACCGTAG
ACGGTAATTGTGCAGGCTG -> CGGTAATTGTGCAGGCTGT
ACGGTAATTGTGCATACGA -> CGGTAATTGTGCATACGAC
ACGTAAAGGCTAGAACAAC -> CGTAAAGGCTAGAACAACA
ACGTCACTAGACTGCGTAA -> CGTCACTAGACTGCGTAAC
ACGTCAGAGGTAGGGAGGT -> CGTCAGAGGTAGGGAGGTG
ACGTCGAAGAGAAAAACCG -> CGTCGAAGAGAAAAACCGC
ACGTGTACTCTTGAAGAGT -> CGTGTACTCTTGAAGAGTA
ACGTGTTCACGCATTGATA -> CGTGTTCACGCATTGATAA
ACGTTACTCGTGTACGAGA -> CGTTACTCGTGTACGAGAG
ACGTTGTTCTTTATTGGTA -> CGTTGTTCTTTATTGGTAA
ACTAATTGGACCAGTTCAT -> CTAATTGGACCAGTTCATG
ACTACGCTAAAACGCTGCA -> CTACGCTAAAACGCTGCAA
ACTAGACTGCGTAACCTGA -> CTAGACTGCGTAACCTGAG
ACTATTCCAACCTTCCCCG -> CTATTCCAACCTTCCCCGT
ACTCACAATCGCGCGTATA -> CTCACAATCGCGCGTATAT
ACTCAGCTATAAGAGTCTG -> CTCAGCTATAAGAGTCTGA
ACTCCTGTCCTCGGGTTAC -> CTCCTGTCCTCGGGTTACC
ACTCGAATCCCCTTTCCTA -> CTCGAATCCCCTTTCCTAT
ACTCGTGTACGAGAGATTT -> CTCGTGTACGAGAGATTTT
ACTCTCAAACTAATTGGAC -> CTCTCAAACTAATTGGACC
ACTCTCTGGAGGCATGAAG -> CTCTCTGGAGGCATGAAGC
ACTCTTATTTGAAGACAGG -> CTCTTATTTGAAGACAGGG
ACTCTTGAAGAGTATTTCA -> CTCTTGAAGAGTATTTCAT
ACTGAAGGGATGAGGCACT -> CTGAAGGGATGAGGCACTG
ACTGCCAGTATCTTGTTTT -> CTGCCAGTATCTTGTTTTG
ACTGCGTAACCTGAGTTCG -> CTGCGTAACCTGAGTTCGG
ACTGCTGACGCCGTGTTTA -> CTGCTGACGCCGTGTTTAT
ACTGGTGGTTCCTGTGGGG -> CTGGTGGTTCCTGTGGGGG
ACTGTACGGTAATTGTGCA -> CTGTACGGTAATTGTGCAA
ACTTAATGAGGTTGGGATG -> CTTAATGAGGTTGGGATGG
ACTTAGGCTGTACGGTAAT -> CTTAGGCTGTACGGTAATT
ACTTCACTCAGCTATAAGA -> CTTCACTCAGCTATAAGAG
ACTTCCGAGTTTTCGAGAT -> CTTCCGAGTTTTCGAGATA
ACTTTGAGCACATACCGCT -> CTTTGAGCACATACCGCTC
ACTTTTTGATAAGTTGTCA -> CTTTTTGATAAGTTGTCAT
AGAAAAACCGCCTCCACAG -> GAAAAACCGCCTCCACAGT
AGAAATGTATAAAGGTTCG -> GAAATGTATAAAGGTTCGC
AGAACAACAACGCCCTGCG -> GAACAACAACGCCCTGCGG
AGAAGCAAAATGAGACCAG -> GAAGCAAAATGAGACCAGG
AGAAGCCGACCAAAGCGTA -> GAAGCCGACCAAAGCGTAT
AGAATTTCGAGTGGCAAAG -> GAATTTCGAGTGGCAAAGG
AGACAAGATAAGTTCAAGT -> GACAAGATAAGTTCAAGTC
AGACAGGGATAAGCAGCAT -> GACAGGGATAAGCAGCATG
AGACCAGGGCTAATACAGC -> GACCAGGGCTAATACAGCA
AGACCCCACACGTTACTCG -> GACCCCACACGTTACTCGT
AGACGCTGGCCCTGTACGG -> GACGCTGGCCCTGTACGGT
AGACGTCACTAGACTGCGT -> GACGTCACTAGACTGCGTA
AGACTGCGTAACCTGAGTT -> GACTGCGTAACCTGAGTTC
AGAGAAAAACCGCCTCCAC -> GAGAAAAACCGCCTCCACA
AGAGAAGCCGACCAAAGCG -> GAGAAGCCGACCAAAGCGT
AGAGATTTTATACTGGTGG -> GAGATTTTATACTGGTGGT
AGAGCACGCGCGACCCTAT -> GAGCACGCGCGACCCTATT
AGAGCCTCTCATAGTACGT -> GAGCCTCTCATAGTACGTA
AGAGCTACTACGCTAAAAC -> GAGCTACTACGCTAAAACG
AGAGCTCAACCCGGGCAGT -> GAGCTCAACCCGGGCAGTT
AGAGCTCCAACCCCCATAG -> GAGCTCCAACCCCCATAGA
AGAGGAAGGCCAAACTTTT -> GAGGAAGGCCAAACTTTTT
AGAGGTAGGGAGGTGAGGG -> GAGGTAGGGAGGTGAGGGA
AGAGTATTTCATAGCTACG -> GAGTATTTCATAGCTACGA
AGAGTCCTACTCTCAAACT -> GAGTCCTACTCTCAAACTA
AGATAAGTTCAAGTCCTGA -> GATAAGTTCAAGTCCTGAC
AGATACAGGTCTCTGGAGA -> GATACAGGTCTCTGGAGAC
AGATGTATAACCTCTGGCC -> GATGTATAACCTCTGGCCT
AGATGTCTGTCGCTCCCAT -> GATGTCTGTCGCTCCCATA
AGATTTTATACTGGTGGTT -> GATTTTATACTGGTGGTTC
AGCAAAATGAGACCAGGGC -> GCAAAATGAGACCAGGGCT
AGCACATACCGCTCATCGG -> GCACATACCGCTCATCGGT
AGCACCTCGGTGATCGGTC -> GCACCTCGGTGATCGGTCC
AGCACGCGCGACCCTATTA -> GCACGCGCGACCCTATTAG
AGCAGACCCCACACGTTAC -> GCAGACCCCACACGTTACT
AGCAGCATGTTTCATCTAA -> GCAGCATGTTTCATCTAAG
AGCAGGAGCTGTCGGTTTC -> GCAGGAGCTGTCGGTTTCA
AGCATGTAGCCGACCAAAG -> GCATGTAGCCGACCAAAGC
AGCATGTTTCATCTAAGTG -> GCATGTTTCATCTAAGTGC
AGCATTTGTTCAAAATGTA -> GCATTTGTTCAAAATGTAC
AGCCAATATTGAGGATGCA -> GCCAATATTGAGGATGCAC
AGCCATCTAAGCTGAATGT -> GCCATCTAAGCTGAATGTC
AGCCCAACGGGTGCGATGA -> GCCCAACGGGTGCGATGAT
AGCCGACCAAAGCGTATGT -> GCCGACCAAAGCGTATGTA,GCCGACCAAAGCGTATGTC,GCCGACCAAAGCGTATGTC,GCCGACCAAAGCGTATGTG
AGCCGACCGATAGACAAGA -> GCCGACCGATAGACAAGAT
AGCCGCAACCATAGTGTCG -> GCCGCAACCATAGTGTCGT
AGCCGGTGAGTAGGACGCC -> GCCGGTGAGTAGGACGCCG
AGCCTCTCATAGTACGTAA -> GCCTCTCATAGTACGTAAA
AGCCTGTCTAGTGACGTGT -> GCCTGTCTAGTGACGTGTA
AGCGTATGTAATTGAACAT -> GCGTATGTAATTGAACATA
AGCGTATGTCCACTCACAA -> GCGTATGTCCACTCACAAT
AGCGTATGTCTTCGCAGGG -> GCGTATGTCTTCGCAGGGA
AGCGTATGTGACATAATAT -> GCGTATGTGACATAATATA
AGCGTCATATCTCTTGGAT -> GCGTCATATCTCTTGGATA
AGCTACGATTTGAACCCCG -> GCTACGATTTGAACCCCGA
AGCTACTACGCTAAAACGC -> GCTACTACGCTAAAACGCT
AGCTAGAGCCTCTCATAGT -> GCTAGAGCCTCTCATAGTA
AGCTATTTTAACTCGAATC -> GCTATTTTAACTCGAATCC
AGCTCAACCCGGGCAGTTC -> GCTCAACCCGGGCAGTTCA
AGCTCCAACCCCCATAGAG -> GCTCCAACCCCCATAGAGC
AGCTCCGGAGGGTCCGTTG -> GCTCCGGAGGGTCCGTTGA
AGCTGAATGTCGATAACCG -> GCTGAATGTCGATAACCGA
AGCTGGAACGCTACGGGTG -> GCTGGAACGCTACGGGTGT
AGCTGTCGGTTTCATGCCG -> GCTGTCGGTTTCATGCCGC
AGGAAGGCCAAACTTTTTG -> GGAAGGCCAAACTTTTTGA
AGGAATGCCGCACAACCTC -> GGAATGCCGCACAACCTCG
AGGACATCCAAATACCGAG -> GGACATCCAAATACCGAGC
AGGACGCCGATATAACTAT -> GGACGCCGATATAACTATT
AGGAGCTGTCGGTTTCATG -> GGAGCTGTCGGTTTCATGC
AGGATGCACCATGTGGGGC -> GGATGCACCATGTGGGGCA
AGGATGGCTCGGTTGGACC -> GGATGGCTCGGTTGGACCG
AGGCACTGTACGGTAATTG -> GGCACTGTACGGTAATTGT
AGGCATGAAGCTCCGGAGG -> GGCATGAAGCTCCGGAGGG
AGGCCAAACTTTTTGATAA -> GGCCAAACTTTTTGATAAG
AGGCGGAGCTAGAGCCTCT -> GGCGGAGCTAGAGCCTCTC
AGGCTAAACATAAAGCTGG -> GGCTAAACATAAAGCTGGA
AGGCTAGAACAACAACGCC -> GGCTAGAACAACAACGCCC
AGGCTGTACGGTAATTGTG -> GGCTGTACGGTAATTGTGC
AGGCTGTGACGGAGCCGAC -> GGCTGTGACGGAGCCGACC
AGGGAGGTGAGGGATTCGT -> GGGAGGTGAGGGATTCGTC
AGGGATAAGCAGCATGTTT -> GGGATAAGCAGCATGTTTC
AGGGATGAGGCACTGTACG -> GGGATGAGGCACTGTACGG
AGGGATGGGATTTAAACGG -> GGGATGGGATTTAAACGGG
AGGGATTCGTCTGGTATTG -> GGGATTCGTCTGGTATTGC
AGGGCCTGGGAGTGCGTGT -> GGGCCTGGGAGTGCGTGTC
AGGGCTAATACAGCAGACC -> GGGCTAATACAGCAGACCC
AGGGGATTAAAATACCGCC -> GGGGATTAAAATACCGCCC
AGGGTCCGTTGACCGACAG -> GGGTCCGTTGACCGACAGT
AGGTAGGGAGGTGAGGGAT -> GGTAGGGAGGTGAGGGATT
AGGTCCTAGAAGCAAAATG -> GGTCCTAGAAGCAAAATGA
AGGTCTCTGGAGACGCTGG -> GGTCTCTGGAGACGCTGGC
AGGTGAAAGCCGCAACCAT -> GGTGAAAGCCGCAACCATA
AGGTGAGGGATTCGTCTGG -> GGTGAGGGATTCGTCTGGT
AGGTGCGCGACAATAGGGC -> GGTGCGCGACAATAGGGCC
AGGTTCGCCACACTTCCGA -> GGTTCGCCACACTTCCGAG
AGGTTGGGATGGATTGGTG -> GGTTGGGATGGATTGGTGG
AGGTTGTGAGTGACGCACG -> GGTTGTGAGTGACGCACGT
AGTAAGTCGAATCGACTTA -> GTAAGTCGAATCGACTTAA
AGTACCGACCCATAAAACT -> GTACCGACCCATAAAACTC
AGTACGTAAAGGCTAGAAC -> GTACGTAAAGGCTAGAACA
AGTAGGACGCCGATATAAC -> GTAGGACGCCGATATAACT
AGTATATCCCGGCAGCATT -> GTATATCCCGGCAGCATTT
AGTATCTTGTTTTGTGGAA -> GTATCTTGTTTTGTGGAAG
AGTATTTCATAGCTACGAT -> GTATTTCATAGCTACGATT
AGTCAAGATGTCTGTCGCT -> GTCAAGATGTCTGTCGCTC
AGTCATAGAGCTCCAACCC -> GTCATAGAGCTCCAACCCC
AGTCCTACTCTCAAACTAA -> GTCCTACTCTCAAACTAAT
AGTCCTGACCCCCTTACAA -> GTCCTGACCCCCTTACAAT
AGTCGAATCGACTTAATGA -> GTCGAATCGACTTAATGAG
AGTCGGACAATGGGGTTGT -> GTCGGACAATGGGGTTGTT
AGTCGTAAACCGCGCGGTT -> GTCGTAAACCGCGCGGTTT
AGTGACACAAAACGACGAG -> GTGACACAAAACGACGAGA
AGTGACGCACGTCAGAGGT -> GTGACGCACGTCAGAGGTA
AGTGACGTCGAAGAGAAAA -> GTGACGTCGAAGAGAAAAA
AGTGACGTGTACTCTTGAA -> GTGACGTGTACTCTTGAAG
AGTGATTGATACTTAGGCT -> GTGATTGATACTTAGGCTG
AGTGCAACAACAGACGTCA -> GTGCAACAACAGACGTCAC
AGTGCATTGCGTTGTCACC -> GTGCATTGCGTTGTCACCT
AGTGCGTGTCCGCAACGAC -> GTGCGTGTCCGCAACGACT
AGTGGCAAAGGACATCCAA -> GTGGCAAAGGACATCCAAA
AGTGTCGTGGTACCCGACC -> GTGTCGTGGTACCCGACCG
AGTTAACATCTTGATCAAT -> GTTAACATCTTGATCAATC
AGTTATACCAGGTCCTAGA -> GTTATACCAGGTCCTAGAA
AGTTCAAGTCCTGACCCCC -> GTTCAAGTCCTGACCCCCT
AGTTCAGGCTAAACATAAA -> GTTCAGGCTAAACATAAAG
AGTTCATGGAAGAGGAAGG -> GTTCATGGAAGAGGAAGGC
AGTTCGGACCGCTATATTT -> GTTCGGACCGCTATATTTG
AGTTGAACAAGTGACGTCG -> GTTGAACAAGTGACGTCGA
AGTTGTCATATTACATACA -> GTTGTCATATTACATACAA
AGTTTTCGAGATACAGGTC -> GTTTTCGAGATACAGGTCT
ATAAAACTCCTGTCCTCGG -> TAAAACTCCTGTCCTCGGG
ATAAAGCTGGAACGCTACG -> TAAAGCTGGAACGCTACGG
ATAAAGGTTCGCCACACTT -> TAAAGGTTCGCCACACTTC
ATAAATCGAGCACCTCGGT -> TAAATCGAGCACCTCGGTG
ATAACATCAGTACCGACCC -> TAACATCAGTACCGACCCA
ATAACCGATATCTGTACGG -> TAACCGATATCTGTACGGT
ATAACCTCTGGCCTTTAGA -> TAACCTCTGGCCTTTAGAG
ATAACTATTCCAACCTTCC -> TAACTATTCCAACCTTCCC
ATAAGCAGCATGTTTCATC -> TAAGCAGCATGTTTCATCT
ATAAGTTCAAGTCCTGACC -> TAAGTTCAAGTCCTGACCC
ATAAGTTGTCATATTACAT -> TAAGTTGTCATATTACATA
ATAATATAGCCATCTAAGC -> TAATATAGCCATCTAAGCT
ATAATTCGTTACCAAAAAA -> TAATTCGTTACCAAAAAAA
ATACAACGTGTTCACGCAT -> TACAACGTGTTCACGCATT
ATACAACTTCACTCAGCTA -> TACAACTTCACTCAGCTAT
ATACACCGAGCTATTTTAA -> TACACCGAGCTATTTTAAC
ATACAGCAGACCCCACACG -> TACAGCAGACCCCACACGT
ATACAGGTCTCTGGAGACG -> TACAGGTCTCTGGAGACGC
ATACCAGGTCCTAGAAGCA -> TACCAGGTCCTAGAAGCAA
ATACCGAGCCAATATTGAG -> TACCGAGCCAATATTGAGG
ATACCGCCCAGAATTTCGA -> TACCGCCCAGAATTTCGAG
ATACCGCTCATCGGTCCTG -> TACCGCTCATCGGTCCTGA
ATACGACGACCTAGCCGAC -> TACGACGACCTAGCCGACC
ATACGATGGTCTACAGAAA -> TACGATGGTCTACAGAAAT
ATACGCCCGGGACTGCTGA -> TACGCCCGGGACTGCTGAC
ATACGGTAAATAGAGCTAC -> TACGGTAAATAGAGCTACT
ATACTGGTGGTTCCTGTGG -> TACTGGTGGTTCCTGTGGG
ATACTTAGGCTGTACGGTA -> TACTTAGGCTGTACGGTAA
ATAGACAAGATAAGTTCAA -> TAGACAAGATAAGTTCAAG
ATAGAGCACGCGCGACCCT -> TAGAGCACGCGCGACCCTA
ATAGAGCTACTACGCTAAA -> TAGAGCTACTACGCTAAAA
ATAGAGCTCCAACCCCCAT -> TAGAGCTCCAACCCCCATA
ATAGCCATCTAAGCTGAAT -> TAGCCATCTAAGCTGAATG
ATAGCTACGATTTGAACCC -> TAGCTACGATTTGAACCCC
ATAGGGCCTGGGAGTGCGT -> TAGGGCCTGGGAGTGCGTG
ATAGGTGAAAGCCGCAACC -> TAGGTGAAAGCCGCAACCA
ATAGTACGTAAAGGCTAGA -> TAGTACGTAAAGGCTAGAA
ATAGTGTCGTGGTACCCGA -> TAGTGTCGTGGTACCCGAC
ATATAACTATTCCAACCTT -> TATAACTATTCCAACCTTC
ATATAGCCATCTAAGCTGA -> TATAGCCATCTAAGCTGAA
ATATCCCGGCAGCATTTGT -> TATCCCGGCAGCATTTGTT
ATATCTCTTGGATAGGTGA -> TATCTCTTGGATAGGTGAA
ATATCTGTACGGTAATTGT -> TATCTGTACGGTAATTGTG
ATATGAGCGTCATATCTCT -> TATGAGCGTCATATCTCTT
ATATGATGGCTGTGGCCGA -> TATGATGGCTGTGGCCGAA
ATATTACATACAACGTGTT -> TATTACATACAACGTGTTC
ATATTCATACACCGAGCTA -> TATTCATACACCGAGCTAT
ATATTGAGGATGCACCATG -> TATTGAGGATGCACCATGT
ATATTTGACCGCGCAGCAG -> TATTTGACCGCGCAGCAGG
ATCAATCGATACGATGGTC -> TCAATCGATACGATGGTCT
ATCAGGGGATTAAAATACC -> TCAGGGGATTAAAATACCG
ATCAGTACCGACCCATAAA -> TCAGTACCGACCCATAAAA
ATCCAAATACCGAGCCAAT -> TCCAAATACCGAGCCAATA
ATCCCCTTTCCTATTTGGA -> TCCCCTTTCCTATTTGGAC
ATCCCGGCAGCATTTGTTC -> TCCCGGCAGCATTTGTTCA
ATCCTAGTGACACAAAACG -> TCCTAGTGACACAAAACGA
ATCGACTTAATGAGGTTGG -> TCGACTTAATGAGGTTGGG
ATCGAGCACCTCGGTGATC -> TCGAGCACCTCGGTGATCG
ATCGATACGATGGTCTACA -> TCGATACGATGGTCTACAG
ATCGCGCGTATATGATGGC -> TCGCGCGTATATGATGGCT
ATCGGTCCGGGCCCTGCGG -> TCGGTCCGGGCCCTGCGGG
ATCGGTCCTGATTTCCGTC -> TCGGTCCTGATTTCCGTCT
ATCGTAGTAAGTCGAATCG -> TCGTAGTAAGTCGAATCGA
ATCGTCACTGCCAGTATCT -> TCGTCACTGCCAGTATCTT
ATCTAAGCTGAATGTCGAT -> TCTAAGCTGAATGTCGATA
ATCTAAGTGCATTGCGTTG -> TCTAAGTGCATTGCGTTGT
ATCTCTTGGATAGGTGAAA -> TCTCTTGGATAGGTGAAAG
ATCTGTACGGTAATTGTGC -> TCTGTACGGTAATTGTGCA
ATCTTGATCAATCGATACG -> TCTTGATCAATCGATACGA
ATCTTGTTTTGTGGAAGAT -> TCTTGTTTTGTGGAAGATG
ATGAAGCCCAACGGGTGCG -> TGAAGCCCAACGGGTGCGA
ATGAAGCTCCGGAGGGTCC -> TGAAGCTCCGGAGGGTCCG
ATGAAGTTAACATCTTGAT -> TGAAGTTAACATCTTGATC
ATGACCAGAGAAGCCGACC -> TGACCAGAGAAGCCGACCA
ATGAGACCAGGGCTAATAC -> TGAGACCAGGGCTAATACA
ATGAGCGTCATATCTCTTG -> TGAGCGTCATATCTCTTGG
ATGAGGCACTGTACGGTAA -> TGAGGCACTGTACGGTAAT
ATGAGGTTGGGATGGATTG -> TGAGGTTGGGATGGATTGG
ATGAGTGCAACAACAGACG -> TGAGTGCAACAACAGACGT
ATGATGGCTGTGGCCGAAC -> TGATGGCTGTGGCCGAACA
ATGATGGGTCAACCATGAA -> TGATGGGTCAACCATGAAG
ATGCACCATGTGGGGCAAC -> TGCACCATGTGGGGCAACG
ATGCCGCACAACCTCGCCC -> TGCCGCACAACCTCGCCCC
ATGCCGCCTTTCTTACCTG -> TGCCGCCTTTCTTACCTGG
ATGGAAGAGGAAGGCCAAA -> TGGAAGAGGAAGGCCAAAC
ATGGATTGGTGGCTGGCCT -> TGGATTGGTGGCTGGCCTC
ATGGCTATCGTAGTAAGTC -> TGGCTATCGTAGTAAGTCG
ATGGCTCGGTTGGACCGAT -> TGGCTCGGTTGGACCGATG
ATGGCTGTAACACGGAAGG -> TGGCTGTAACACGGAAGGA
ATGGCTGTGGCCGAACACA -> TGGCTGTGGCCGAACACAG
ATGGGATTTAAACGGGTTA -> TGGGATTTAAACGGGTTAC
ATGGGGTTGTTCGTTTGTA -> TGGGGTTGTTCGTTTGTAT
ATGGGTCAACCATGAAGTT -> TGGGTCAACCATGAAGTTA
ATGGTCTACAGAAATGTAT -> TGGTCTACAGAAATGTATA
ATGTAATTGAACATATTCA -> TGTAATTGAACATATTCAT
ATGTACAGCCTGTCTAGTG -> TGTACAGCCTGTCTAGTGA
ATGTAGCCGACCAAAGCGT -> TGTAGCCGACCAAAGCGTA
ATGTATAAAGGTTCGCCAC -> TGTATAAAGGTTCGCCACA
ATGTATAACCTCTGGCCTT -> TGTATAACCTCTGGCCTTT
ATGTCCACTCACAATCGCG -> TGTCCACTCACAATCGCGC
ATGTCGATAACCGATATCT -> TGTCGATAACCGATATCTG
ATGTCGGATATGAGCGTCA -> TGTCGGATATGAGCGTCAT
ATGTCTGTCGCTCCCATAC -> TGTCTGTCGCTCCCATACA
ATGTCTTCGCAGGGATGGG -> TGTCTTCGCAGGGATGGGA
ATGTGACATAATATAGCCA -> TGTGACATAATATAGCCAT
ATGTGGGGCAACGTTGTTC -> TGTGGGGCAACGTTGTTCT
ATGTTTCATCTAAGTGCAT -> TGTTTCATCTAAGTGCATT
ATTAAAATACCGCCCAGAA -> TTAAAATACCGCCCAGAAT
ATTACATACAACGTGTTCA -> TTACATACAACGTGTTCAC
ATTAGCCGGTGAGTAGGAC -> TTAGCCGGTGAGTAGGACG
ATTAGTATATCCCGGCAGC -> TTAGTATATCCCGGCAGCA
ATTCATACACCGAGCTATT -> TTCATACACCGAGCTATTT
ATTCCAACCTTCCCCGTTC -> TTCCAACCTTCCCCGTTCC
ATTCGGTGACTCTCTGGAG -> TTCGGTGACTCTCTGGAGG
ATTCGTCTGGTATTGCTGC -> TTCGTCTGGTATTGCTGCC
ATTCGTTACCAAAAAAATA -> TTCGTTACCAAAAAAATAA
ATTGAACATATTCATACAC -> TTGAACATATTCATACACC
ATTGAGGATGCACCATGTG -> TTGAGGATGCACCATGTGG
ATTGATAAATCGAGCACCT -> TTGATAAATCGAGCACCTC
ATTGATACTTAGGCTGTAC -> TTGATACTTAGGCTGTACG
ATTGCGTTGTCACCTGAAT -> TTGCGTTGTCACCTGAATT
ATTGCTGCCATGGCTGTAA -> TTGCTGCCATGGCTGTAAC
ATTGGACCAGTTCATGGAA -> TTGGACCAGTTCATGGAAG
ATTGGTAAGTCATAGAGCT -> TTGGTAAGTCATAGAGCTC
ATTGGTGGCTGGCCTCTCT -> TTGGTGGCTGGCCTCTCTG
ATTGTGCAATGACCAGAGA -> TTGTGCAATGACCAGAGAA
ATTGTGCACCGTAGCATGT -> TTGTGCACCGTAGCATGTA
ATTGTGCAGGCTGTGACGG -> TTGTGCAGGCTGTGACGGA
ATTGTGCATACGACGACCT -> TTGTGCATACGACGACCTA
ATTTAAACGGGTTACCGAC -> TTTAAACGGGTTACCGACC
ATTTCATAGCTACGATTTG -> TTTCATAGCTACGATTTGA
ATTTCCGTCTCCTGTATAC -> TTTCCGTCTCCTGTATACG
ATTTCGAGTGGCAAAGGAC -> TTTCGAGTGGCAAAGGACA
ATTTGAACCCCGACTGAAG -> TTTGAACCCCGACTGAAGG
ATTTGAAGACAGGGATAAG -> TTTGAAGACAGGGATAAGC
ATTTGACCGCGCAGCAGGA -> TTTGACCGCGCAGCAGGAG
ATTTGGACGGCTGTCCCCA -> TTTGGACGGCTGTCCCCAC
ATTTGTTCAAAATGTACAG -> TTTGTTCAAAATGTACAGC
ATTTTAACTCGAATCCCCT -> TTTTAACTCGAATCCCCTT
ATTTTATACTGGTGGTTCC -> TTTTATACTGGTGGTTCCT
CAAAAAAATAACATCAGTA -> AAAAAAATAACATCAGTAC
CAAAACGACGAGAGCTCAA -> AAAACGACGAGAGCTCAAC
CAAAATGAGACCAGGGCTA -> AAAATGAGACCAGGGCTAA
CAAAATGTACAGCCTGTCT -> AAAATGTACAGCCTGTCTA
CAAACTAATTGGACCAGTT -> AAACTAATTGGACCAGTTC
CAAACTTTTTGATAAGTTG -> AAACTTTTTGATAAGTTGT
CAAAGCGTATGTAATTGAA -> AAAGCGTATGTAATTGAAC
CAAAGCGTATGTCCACTCA -> AAAGCGTATGTCCACTCAC
CAAAGCGTATGTCTTCGCA -> AAAGCGTATGTCTTCGCAG
CAAAGCGTATGTGACATAA -> AAAGCGTATGTGACATAAT
CAAAGGACATCCAAATACC -> AAAGGACATCCAAATACCG
CAAATACCGAGCCAATATT -> AAATACCGAGCCAATATTG
CAACAACAGACGTCACTAG -> AACAACAGACGTCACTAGA
CAACAACGCCCTGCGGAGG -> AACAACGCCCTGCGGAGGT
CAACAGACGTCACTAGACT -> AACAGACGTCACTAGACTG
CAACCAGGATGGCTCGGTT -> AACCAGGATGGCTCGGTTG
CAACCATAGTGTCGTGGTA -> AACCATAGTGTCGTGGTAC
CAACCATGAAGTTAACATC -> AACCATGAAGTTAACATCT
CAACCCCCATAGAGCACGC -> AACCCCCATAGAGCACGCG
CAACCCGGGCAGTTCAGGC -> AACCCGGGCAGTTCAGGCT
CAACCTCGCCCCGAGTTGA -> AACCTCGCCCCGAGTTGAA
CAACCTTCCCCGTTCCCAA -> AACCTTCCCCGTTCCCAAT
CAACGACTCTTATTTGAAG -> AACGACTCTTATTTGAAGA
CAACGCCCTGCGGAGGTGC -> AACGCCCTGCGGAGGTGCG
CAACGGGTGCGATGATGGG -> AACGGGTGCGATGATGGGT
CAACGTGTTCACGCATTGA -> AACGTGTTCACGCATTGAT
CAACGTTGTTCTTTATTGG -> AACGTTGTTCTTTATTGGT
CAACTTCACTCAGCTATAA -> AACTTCACTCAGCTATAAG
CAAGATAAGTTCAAGTCCT -> AAGATAAGTTCAAGTCCTG
CAAGATGTCTGTCGCTCCC -> AAGATGTCTGTCGCTCCCA
CAAGTCCTGACCCCCTTAC -> AAGTCCTGACCCCCTTACA
CAAGTGACGTCGAAGAGAA -> AAGTGACGTCGAAGAGAAA
CAATACGGTAAATAGAGCT -> AATACGGTAAATAGAGCTA
CAATAGGGCCTGGGAGTGC -> AATAGGGCCTGGGAGTGCG
CAATATTGAGGATGCACCA -> AATATTGAGGATGCACCAT
CAATCCTAGTGACACAAAA -> AATCCTAGTGACACAAAAC
CAATCGATACGATGGTCTA -> AATCGATACGATGGTCTAC
CAATCGCGCGTATATGATG -> AATCGCGCGTATATGATGG
CAATGACCAGAGAAGCCGA -> AATGACCAGAGAAGCCGAC
CAATGGGGTTGTTCGTTTG -> AATGGGGTTGTTCGTTTGT
CAATGTCGGATATGAGCGT -> AATGTCGGATATGAGCGTC
CACAAAACGACGAGAGCTC -> ACAAAACGACGAGAGCTCA
CACAACCTCGCCCCGAGTT -> ACAACCTCGCCCCGAGTTG
CACAATCGCGCGTATATGA -> ACAATCGCGCGTATATGAT
CACACGTTACTCGTGTACG -> ACACGTTACTCGTGTACGA
CACACTTCCGAGTTTTCGA -> ACACTTCCGAGTTTTCGAG
CACAGGCGGAGCTAGAGCC -> ACAGGCGGAGCTAGAGCCT
CACAGTGATTGATACTTAG -> ACAGTGATTGATACTTAGG
CACATACCGCTCATCGGTC -> ACATACCGCTCATCGGTCC
CACCATGTGGGGCAACGTT -> ACCATGTGGGGCAACGTTG
CACCGAGCTATTTTAACTC -> ACCGAGCTATTTTAACTCG
CACCGTAGCATGTAGCCGA -> ACCGTAGCATGTAGCCGAC
CACCTATCGTCACTGCCAG -> ACCTATCGTCACTGCCAGT
CACCTCGGTGATCGGTCCG -> ACCTCGGTGATCGGTCCGG
CACCTGAATTCGGTGACTC -> ACCTGAATTCGGTGACTCT
CACGCATTGATAAATCGAG -> ACGCATTGATAAATCGAGC
CACGCGCGACCCTATTAGT -> ACGCGCGACCCTATTAGTA
CACGGAAGGAATGCCGCAC -> ACGGAAGGAATGCCGCACA
CACGTCAGAGGTAGGGAGG -> ACGTCAGAGGTAGGGAGGT
CACGTTACTCGTGTACGAG -> ACGTTACTCGTGTACGAGA
CACTAGACTGCGTAACCTG -> ACTAGACTGCGTAACCTGA
CACTCACAATCGCGCGTAT -> ACTCACAATCGCGCGTATA
CACTCAGCTATAAGAGTCT -> ACTCAGCTATAAGAGTCTG
CACTGCCAGTATCTTGTTT -> ACTGCCAGTATCTTGTTTT
CACTGTACGGTAATTGTGC -> ACTGTACGGTAATTGTGCA
CACTTCCGAGTTTTCGAGA -> ACTTCCGAGTTTTCGAGAT
CAGAAATGTATAAAGGTTC -> AGAAATGTATAAAGGTTCG
CAGAATTTCGAGTGGCAAA -> AGAATTTCGAGTGGCAAAG
CAGACCCCACACGTTACTC -> AGACCCCACACGTTACTCG
CAGACGTCACTAGACTGCG -> AGACGTCACTAGACTGCGT
CAGAGAAGCCGACCAAAGC -> AGAGAAGCCGACCAAAGCG
CAGAGGTAGGGAGGTGAGG -> AGAGGTAGGGAGGTGAGGG
CAGCAGACCCCACACGTTA -> AGCAGACCCCACACGTTAC
CAGCAGGAGCTGTCGGTTT -> AGCAGGAGCTGTCGGTTTC
CAGCATGTTTCATCTAAGT -> AGCATGTTTCATCTAAGTG
CAGCATTTGTTCAAAATGT -> AGCATTTGTTCAAAATGTA
CAGCCGACCGATAGACAAG -> AGCCGACCGATAGACAAGA
CAGCCTGTCTAGTGACGTG -> AGCCTGTCTAGTGACGTGT
CAGGAGCTGTCGGTTTCAT -> AGGAGCTGTCGGTTTCATG
CAGGATGGCTCGGTTGGAC -> AGGATGGCTCGGTTGGACC
CAGGCGGAGCTAGAGCCTC -> AGGCGGAGCTAGAGCCTCT
CAGGCTAAACATAAAGCTG -> AGGCTAAACATAAAGCTGG
CAGGCTGTGACGGAGCCGA -> AGGCTGTGACGGAGCCGAC
CAGGGATAAGCAGCATGTT -> AGGGATAAGCAGCATGTTT
CAGGGATGGGATTTAAACG -> AGGGATGGGATTTAAACGG
CAGGGCTAATACAGCAGAC -> AGGGCTAATACAGCAGACC
CAGGGGATTAAAATACCGC -> AGGGGATTAAAATACCGCC
CAGGTCCTAGAAGCAAAAT -> AGGTCCTAGAAGCAAAATG
CAGGTCTCTGGAGACGCTG -> AGGTCTCTGGAGACGCTGG
CAGTACCGACCCATAAAAC -> AGTACCGACCCATAAAACT
CAGTATCTTGTTTTGTGGA -> AGTATCTTGTTTTGTGGAA
CAGTCAAGATGTCTGTCGC -> AGTCAAGATGTCTGTCGCT
CAGTCGGACAATGGGGTTG -> AGTCGGACAATGGGGTTGT
CAGTCGTAAACCGCGCGGT -> AGTCGTAAACCGCGCGGTT
CAGTGATTGATACTTAGGC -> AGTGATTGATACTTAGGCT
CAGTTATACCAGGTCCTAG -> AGTTATACCAGGTCCTAGA
CAGTTCAGGCTAAACATAA -> AGTTCAGGCTAAACATAAA
CAGTTCATGGAAGAGGAAG -> AGTTCATGGAAGAGGAAGG
CATAAAACTCCTGTCCTCG -> ATAAAACTCCTGTCCTCGG
CATAAAGCTGGAACGCTAC -> ATAAAGCTGGAACGCTACG
CATAATATAGCCATCTAAG -> ATAATATAGCCATCTAAGC
CATACAACGTGTTCACGCA -> ATACAACGTGTTCACGCAT
CATACAACTTCACTCAGCT -> ATACAACTTCACTCAGCTA
CATACACCGAGCTATTTTA -> ATACACCGAGCTATTTTAA
CATACCGCTCATCGGTCCT -> ATACCGCTCATCGGTCCTG
CATACGACGACCTAGCCGA -> ATACGACGACCTAGCCGAC
CATAGAGCACGCGCGACCC -> ATAGAGCACGCGCGACCCT
CATAGAGCTCCAACCCCCA -> ATAGAGCTCCAACCCCCAT
CATAGCTACGATTTGAACC -> ATAGCTACGATTTGAACCC
CATAGTACGTAAAGGCTAG -> ATAGTACGTAAAGGCTAGA
CATAGTGTCGTGGTACCCG -> ATAGTGTCGTGGTACCCGA
CATATCTCTTGGATAGGTG -> ATATCTCTTGGATAGGTGA
CATATTACATACAACGTGT -> ATATTACATACAACGTGTT
CATATTCATACACCGAGCT -> ATATTCATACACCGAGCTA
CATCAGTACCGACCCATAA -> ATCAGTACCGACCCATAAA
CATCCAAATACCGAGCCAA -> ATCCAAATACCGAGCCAAT
CATCGGTCCTGATTTCCGT -> ATCGGTCCTGATTTCCGTC
CATCTAAGCTGAATGTCGA -> ATCTAAGCTGAATGTCGAT
CATCTAAGTGCATTGCGTT -> ATCTAAGTGCATTGCGTTG
CATCTTGATCAATCGATAC -> ATCTTGATCAATCGATACG
CATGAAGCCCAACGGGTGC -> ATGAAGCCCAACGGGTGCG
CATGAAGCTCCGGAGGGTC -> ATGAAGCTCCGGAGGGTCC
CATGAAGTTAACATCTTGA -> ATGAAGTTAACATCTTGAT
CATGCCGCCTTTCTTACCT -> ATGCCGCCTTTCTTACCTG
CATGGAAGAGGAAGGCCAA -> ATGGAAGAGGAAGGCCAAA
CATGGCTGTAACACGGAAG -> ATGGCTGTAACACGGAAGG
CATGTAGCCGACCAAAGCG -> ATGTAGCCGACCAAAGCGT
CATGTGGGGCAACGTTGTT -> ATGTGGGGCAACGTTGTTC
CATGTTTCATCTAAGTGCA -> ATGTTTCATCTAAGTGCAT
CATTGATAAATCGAGCACC -> ATTGATAAATCGAGCACCT
CATTGCGTTGTCACCTGAA -> ATTGCGTTGTCACCTGAAT
CATTTGTTCAAAATGTACA -> ATTTGTTCAAAATGTACAG
CCAAAAAAATAACATCAGT -> CAAAAAAATAACATCAGTA
CCAAACTTTTTGATAAGTT -> CAAACTTTTTGATAAGTTG
CCAAAGCGTATGTAATTGA -> CAAAGCGTATGTAATTGAA
CCAAAGCGTATGTCCACTC -> CAAAGCGTATGTCCACTCA
CCAAAGCGTATGTCTTCGC -> CAAAGCGTATGTCTTCGCA
CCAAAGCGTATGTGACATA -> CAAAGCGTATGTGACATAA
CCAAATACCGAGCCAATAT -> CAAATACCGAGCCAATATT
CCAACCCCCATAGAGCACG -> CAACCCCCATAGAGCACGC
CCAACCTTCCCCGTTCCCA -> CAACCTTCCCCGTTCCCAA
CCAACGGGTGCGATGATGG -> CAACGGGTGCGATGATGGG
CCAATACGGTAAATAGAGC -> CAATACGGTAAATAGAGCT
CCAATATTGAGGATGCACC -> CAATATTGAGGATGCACCA
CCACACGTTACTCGTGTAC -> CACACGTTACTCGTGTACG
CCACACTTCCGAGTTTTCG -> CACACTTCCGAGTTTTCGA
CCACAGTGATTGATACTTA -> CACAGTGATTGATACTTAG
CCACCTATCGTCACTGCCA -> CACCTATCGTCACTGCCAG
CCACTCACAATCGCGCGTA -> CACTCACAATCGCGCGTAT
CCAGAATTTCGAGTGGCAA -> CAGAATTTCGAGTGGCAAA
CCAGAGAAGCCGACCAAAG -> CAGAGAAGCCGACCAAAGC
CCAGGATGGCTCGGTTGGA -> CAGGATGGCTCGGTTGGAC
CCAGGGCTAATACAGCAGA -> CAGGGCTAATACAGCAGAC
CCAGGTCCTAGAAGCAAAA -> CAGGTCCTAGAAGCAAAAT
CCAGTATCTTGTTTTGTGG -> CAGTATCTTGTTTTGTGGA
CCAGTCAAGATGTCTGTCG -> CAGTCAAGATGTCTGTCGC
CCAGTTCATGGAAGAGGAA -> CAGTTCATGGAAGAGGAAG
CCATAAAACTCCTGTCCTC -> CATAAAACTCCTGTCCTCG
CCATACAACTTCACTCAGC -> CATACAACTTCACTCAGCT
CCATAGAGCACGCGCGACC -> CATAGAGCACGCGCGACCC
CCATAGTGTCGTGGTACCC -> CATAGTGTCGTGGTACCCG
CCATCTAAGCTGAATGTCG -> CATCTAAGCTGAATGTCGA
CCATGAAGTTAACATCTTG -> CATGAAGTTAACATCTTGA
CCATGGCTGTAACACGGAA -> CATGGCTGTAACACGGAAG
CCATGTGGGGCAACGTTGT -> CATGTGGGGCAACGTTGTT
CCCAACGGGTGCGATGATG -> CCAACGGGTGCGATGATGG
CCCAATACGGTAAATAGAG -> CCAATACGGTAAATAGAGC
CCCACACGTTACTCGTGTA -> CCACACGTTACTCGTGTAC
CCCACCTATCGTCACTGCC -> CCACCTATCGTCACTGCCA
CCCAGAATTTCGAGTGGCA -> CCAGAATTTCGAGTGGCAA
CCCATAAAACTCCTGTCCT -> CCATAAAACTCCTGTCCTC
CCCATACAACTTCACTCAG -> CCATACAACTTCACTCAGC
CCCATAGAGCACGCGCGAC -> CCATAGAGCACGCGCGACC
CCCCACACGTTACTCGTGT -> CCCACACGTTACTCGTGTA
CCCCACCTATCGTCACTGC -> CCCACCTATCGTCACTGCC
CCCCATAGAGCACGCGCGA -> CCCATAGAGCACGCGCGAC
CCCCCATAGAGCACGCGCG -> CCCCATAGAGCACGCGCGA
CCCCCTTACAATGTCGGAT -> CCCCTTACAATGTCGGATA
CCCCGACTGAAGGGATGAG -> CCCGACTGAAGGGATGAGG
CCCCGAGTTGAACAAGTGA -> CCCGAGTTGAACAAGTGAC
CCCCGTTCCCAATACGGTA -> CCCGTTCCCAATACGGTAA
CCCCTTACAATGTCGGATA -> CCCTTACAATGTCGGATAT
CCCCTTTCCTATTTGGACG -> CCCTTTCCTATTTGGACGG
CCCGACCGGCGAACCTTTT -> CCGACCGGCGAACCTTTTG
CCCGACGGATTAGCCGGTG -> CCGACGGATTAGCCGGTGA
CCCGACTGAAGGGATGAGG -> CCGACTGAAGGGATGAGGC
CCCGAGTTGAACAAGTGAC -> CCGAGTTGAACAAGTGACG
CCCGGCAGCATTTGTTCAA -> CCGGCAGCATTTGTTCAAA
CCCGGGACTGCTGACGCCG -> CCGGGACTGCTGACGCCGT
CCCGGGCAGTTCAGGCTAA -> CCGGGCAGTTCAGGCTAAA
CCCGGTGATGGCTATCGTA -> CCGGTGATGGCTATCGTAG
CCCGTTCCCAATACGGTAA -> CCGTTCCCAATACGGTAAA
CCCTATTAGTATATCCCGG -> CCTATTAGTATATCCCGGC
CCCTGCGGAGGTGCGCGAC -> CCTGCGGAGGTGCGCGACA
CCCTGCGGGCCAGTCAAGA -> CCTGCGGGCCAGTCAAGAT
CCCTGTACGGTAATTGTGC -> CCTGTACGGTAATTGTGCA
CCCTTACAATGTCGGATAT -> CCTTACAATGTCGGATATG
CCCTTTCCTATTTGGACGG -> CCTTTCCTATTTGGACGGC
CCGAACACAGGCGGAGCTA -> CGAACACAGGCGGAGCTAG
CCGACAGTTATACCAGGTC -> CGACAGTTATACCAGGTCC
CCGACCAAAGCGTATGTAA -> CGACCAAAGCGTATGTAAT
CCGACCAAAGCGTATGTCC -> CGACCAAAGCGTATGTCCA
CCGACCAAAGCGTATGTCT -> CGACCAAAGCGTATGTCTT
CCGACCAAAGCGTATGTGA -> CGACCAAAGCGTATGTGAC
CCGACCCATAAAACTCCTG -> CGACCCATAAAACTCCTGT
CCGACCCGGTGATGGCTAT -> CGACCCGGTGATGGCTATC
CCGACCGATAGACAAGATA -> CGACCGATAGACAAGATAA
CCGACCGGCGAACCTTTTG -> CGACCGGCGAACCTTTTGG
CCGACGGATTAGCCGGTGA -> CGACGGATTAGCCGGTGAG
CCGACTGAAGGGATGAGGC -> CGACTGAAGGGATGAGGCA
CCGAGCCAATATTGAGGAT -> CGAGCCAATATTGAGGATG
CCGAGCTATTTTAACTCGA -> CGAGCTATTTTAACTCGAA
CCGAGTTGAACAAGTGACG -> CGAGTTGAACAAGTGACGT
CCGAGTTTTCGAGATACAG -> CGAGTTTTCGAGATACAGG
CCGATAGACAAGATAAGTT -> CGATAGACAAGATAAGTTC
CCGATATAACTATTCCAAC -> CGATATAACTATTCCAACC
CCGATATCTGTACGGTAAT -> CGATATCTGTACGGTAATT
CCGATGAGTGCAACAACAG -> CGATGAGTGCAACAACAGA
CCGCAACCATAGTGTCGTG -> CGCAACCATAGTGTCGTGG
CCGCAACGACTCTTATTTG -> CGCAACGACTCTTATTTGA
CCGCACAACCTCGCCCCGA -> CGCACAACCTCGCCCCGAG
CCGCAGTCGTAAACCGCGC -> CGCAGTCGTAAACCGCGCG
CCGCCCAGAATTTCGAGTG -> CGCCCAGAATTTCGAGTGG
CCGCCTCCACAGTGATTGA -> CGCCTCCACAGTGATTGAT
CCGCCTTTCTTACCTGGCT -> CGCCTTTCTTACCTGGCTG
CCGCGCAGCAGGAGCTGTC -> CGCGCAGCAGGAGCTGTCG
CCGCGCGGTTTCAATCCTA -> CGCGCGGTTTCAATCCTAG
CCGCTATATTTGACCGCGC -> CGCTATATTTGACCGCGCA
CCGCTCATCGGTCCTGATT -> CGCTCATCGGTCCTGATTT
CCGGAGGGTCCGTTGACCG -> CGGAGGGTCCGTTGACCGA
CCGGCAGCATTTGTTCAAA -> CGGCAGCATTTGTTCAAAA
CCGGCGAACCTTTTGGGTT -> CGGCGAACCTTTTGGGTTT
CCGGGACTGCTGACGCCGT -> CGGGACTGCTGACGCCGTG
CCGGGCAGTTCAGGCTAAA -> CGGGCAGTTCAGGCTAAAC
CCGGGCCCTGCGGGCCAGT -> CGGGCCCTGCGGGCCAGTC
CCGGTGAGTAGGACGCCGA -> CGGTGAGTAGGACGCCGAT
CCGGTGATGGCTATCGTAG -> CGGTGATGGCTATCGTAGT
CCGTAGCATGTAGCCGACC -> CGTAGCATGTAGCCGACCA
CCGTCTCCTGTATACGCCC -> CGTCTCCTGTATACGCCCG
CCGTGTTTATAATTCGTTA -> CGTGTTTATAATTCGTTAC
CCGTTCCCAATACGGTAAA -> CGTTCCCAATACGGTAAAT
CCGTTGACCGACAGTTATA -> CGTTGACCGACAGTTATAC
CCTACTCTCAAACTAATTG -> CTACTCTCAAACTAATTGG
CCTAGAAGCAAAATGAGAC -> CTAGAAGCAAAATGAGACC
CCTAGCCGACCAAAGCGTA -> CTAGCCGACCAAAGCGTAT
CCTAGTGACACAAAACGAC -> CTAGTGACACAAAACGACG
CCTATCGTCACTGCCAGTA -> CTATCGTCACTGCCAGTAT
CCTATTAGTATATCCCGGC -> CTATTAGTATATCCCGGCA
CCTATTTGGACGGCTGTCC -> CTATTTGGACGGCTGTCCC
CCTCCACAGTGATTGATAC -> CTCCACAGTGATTGATACT
CCTCGCCCCGAGTTGAACA -> CTCGCCCCGAGTTGAACAA
CCTCGGGTTACCGCAGTCG -> CTCGGGTTACCGCAGTCGT
CCTCGGTGATCGGTCCGGG -> CTCGGTGATCGGTCCGGGC
CCTCTCATAGTACGTAAAG -> CTCTCATAGTACGTAAAGG
CCTCTCTGCAGTCGGACAA -> CTCTCTGCAGTCGGACAAT
CCTCTGGCCTTTAGAGTCC -> CTCTGGCCTTTAGAGTCCT
CCTGAATTCGGTGACTCTC -> CTGAATTCGGTGACTCTCT
CCTGACCCCCTTACAATGT -> CTGACCCCCTTACAATGTC
CCTGAGTTCGGACCGCTAT -> CTGAGTTCGGACCGCTATA
CCTGATTTCCGTCTCCTGT -> CTGATTTCCGTCTCCTGTA
CCTGCGGAGGTGCGCGACA -> CTGCGGAGGTGCGCGACAA
CCTGCGGGCCAGTCAAGAT -> CTGCGGGCCAGTCAAGATG
CCTGGCTGGGCATGAAGCC -> CTGGCTGGGCATGAAGCCC
CCTGGGAGTGCGTGTCCGC -> CTGGGAGTGCGTGTCCGCA
CCTGTACGGTAATTGTGCA -> CTGTACGGTAATTGTGCAC
CCTGTATACGCCCGGGACT -> CTGTATACGCCCGGGACTG
CCTGTCCTCGGGTTACCGC -> CTGTCCTCGGGTTACCGCA
CCTGTCTAGTGACGTGTAC -> CTGTCTAGTGACGTGTACT
CCTGTGGGGGCAGCCGACC -> CTGTGGGGGCAGCCGACCG
CCTTACAATGTCGGATATG -> CTTACAATGTCGGATATGA
CCTTCCCCGTTCCCAATAC -> CTTCCCCGTTCCCAATACG
CCTTTAGAGTCCTACTCTC -> CTTTAGAGTCCTACTCTCA
CCTTTCCTATTTGGACGGC -> CTTTCCTATTTGGACGGCT
CCTTTCTTACCTGGCTGGG -> CTTTCTTACCTGGCTGGGC
CCTTTTGGGTTTTAGGTTG -> CTTTTGGGTTTTAGGTTGT
CGAACACAGGCGGAGCTAG -> GAACACAGGCGGAGCTAGA
CGAACCTTTTGGGTTTTAG -> GAACCTTTTGGGTTTTAGG
CGAAGAGAAAAACCGCCTC -> GAAGAGAAAAACCGCCTCC
CGAATCCCCTTTCCTATTT -> GAATCCCCTTTCCTATTTG
CGAATCGACTTAATGAGGT -> GAATCGACTTAATGAGGTT
CGACAATAGGGCCTGGGAG -> GACAATAGGGCCTGGGAGT
CGACAGTTATACCAGGTCC -> GACAGTTATACCAGGTCCT
CGACCAAAGCGTATGTAAT -> GACCAAAGCGTATGTAATT
CGACCAAAGCGTATGTCCA -> GACCAAAGCGTATGTCCAC
CGACCAAAGCGTATGTCTT -> GACCAAAGCGTATGTCTTC
CGACCAAAGCGTATGTGAC -> GACCAAAGCGTATGTGACA
CGACCCATAAAACTCCTGT -> GACCCATAAAACTCCTGTC
CGACCCGGTGATGGCTATC -> GACCCGGTGATGGCTATCG
CGACCCTATTAGTATATCC -> GACCCTATTAGTATATCCC
CGACCGATAGACAAGATAA -> GACCGATAGACAAGATAAG
CGACCGGCGAACCTTTTGG -> GACCGGCGAACCTTTTGGG
CGACCTAGCCGACCAAAGC -> GACCTAGCCGACCAAAGCG
CGACGACCTAGCCGACCAA -> GACGACCTAGCCGACCAAA
CGACGAGAGCTCAACCCGG -> GACGAGAGCTCAACCCGGG
CGACGGATTAGCCGGTGAG -> GACGGATTAGCCGGTGAGT
CGACTCTTATTTGAAGACA -> GACTCTTATTTGAAGACAG
CGACTGAAGGGATGAGGCA -> GACTGAAGGGATGAGGCAC
CGACTTAATGAGGTTGGGA -> GACTTAATGAGGTTGGGAT
CGAGAGATTTTATACTGGT -> GAGAGATTTTATACTGGTG
CGAGAGCTCAACCCGGGCA -> GAGAGCTCAACCCGGGCAG
CGAGATACAGGTCTCTGGA -> GAGATACAGGTCTCTGGAG
CGAGCACCTCGGTGATCGG -> GAGCACCTCGGTGATCGGT
CGAGCCAATATTGAGGATG -> GAGCCAATATTGAGGATGC
CGAGCTATTTTAACTCGAA -> GAGCTATTTTAACTCGAAT
CGAGTGGCAAAGGACATCC -> GAGTGGCAAAGGACATCCA
CGAGTTGAACAAGTGACGT -> GAGTTGAACAAGTGACGTC
CGAGTTTTCGAGATACAGG -> GAGTTTTCGAGATACAGGT
CGATAACCGATATCTGTAC -> GATAACCGATATCTGTACG
CGATACGATGGTCTACAGA -> GATACGATGGTCTACAGAA
CGATAGACAAGATAAGTTC -> GATAGACAAGATAAGTTCA
CGATATAACTATTCCAACC -> GATATAACTATTCCAACCT
CGATATCTGTACGGTAATT -> GATATCTGTACGGTAATTG
CGATGAGTGCAACAACAGA -> GATGAGTGCAACAACAGAC
CGATGATGGGTCAACCATG -> GATGATGGGTCAACCATGA
CGATGGTCTACAGAAATGT -> GATGGTCTACAGAAATGTA
CGATTTGAACCCCGACTGA -> GATTTGAACCCCGACTGAA
CGCAACCATAGTGTCGTGG -> GCAACCATAGTGTCGTGGT
CGCAACGACTCTTATTTGA -> GCAACGACTCTTATTTGAA
CGCACAACCTCGCCCCGAG -> GCACAACCTCGCCCCGAGT
CGCACGTCAGAGGTAGGGA -> GCACGTCAGAGGTAGGGAG
CGCAGCAGGAGCTGTCGGT -> GCAGCAGGAGCTGTCGGTT
CGCAGGGATGGGATTTAAA -> GCAGGGATGGGATTTAAAC
CGCAGTCGTAAACCGCGCG -> GCAGTCGTAAACCGCGCGG
CGCATTGATAAATCGAGCA -> GCATTGATAAATCGAGCAC
CGCCACACTTCCGAGTTTT -> GCCACACTTCCGAGTTTTC
CGCCCAGAATTTCGAGTGG -> GCCCAGAATTTCGAGTGGC
CGCCCCGAGTTGAACAAGT -> GCCCCGAGTTGAACAAGTG
CGCCCGGGACTGCTGACGC -> GCCCGGGACTGCTGACGCC
CGCCCTGCGGAGGTGCGCG -> GCCCTGCGGAGGTGCGCGA
CGCCGATATAACTATTCCA -> GCCGATATAACTATTCCAA
CGCCGTGTTTATAATTCGT -> GCCGTGTTTATAATTCGTT
CGCCTCCACAGTGATTGAT -> GCCTCCACAGTGATTGATA
CGCCTTTCTTACCTGGCTG -> GCCTTTCTTACCTGGCTGG
CGCGACAATAGGGCCTGGG -> GCGACAATAGGGCCTGGGA
CGCGACCCTATTAGTATAT -> GCGACCCTATTAGTATATC
CGCGCAGCAGGAGCTGTCG -> GCGCAGCAGGAGCTGTCGG
CGCGCGACCCTATTAGTAT -> GCGCGACCCTATTAGTATA
CGCGCGGTTTCAATCCTAG -> GCGCGGTTTCAATCCTAGT
CGCGCGTATATGATGGCTG -> GCGCGTATATGATGGCTGT
CGCGGTTTCAATCCTAGTG -> GCGGTTTCAATCCTAGTGA
CGCGTATATGATGGCTGTG -> GCGTATATGATGGCTGTGG
CGCTAAAACGCTGCAACCA -> GCTAAAACGCTGCAACCAG
CGCTACGGGTGTTGTACCC -> GCTACGGGTGTTGTACCCG
CGCTATATTTGACCGCGCA -> GCTATATTTGACCGCGCAG
CGCTCATCGGTCCTGATTT -> GCTCATCGGTCCTGATTTC
CGCTCCCATACAACTTCAC -> GCTCCCATACAACTTCACT
CGCTGCAACCAGGATGGCT -> GCTGCAACCAGGATGGCTC
CGCTGGCCCTGTACGGTAA -> GCTGGCCCTGTACGGTAAT
CGGAAGGAATGCCGCACAA -> GGAAGGAATGCCGCACAAC
CGGACAATGGGGTTGTTCG -> GGACAATGGGGTTGTTCGT
CGGACCGCTATATTTGACC -> GGACCGCTATATTTGACCG
CGGAGCCGACCAAAGCGTA -> GGAGCCGACCAAAGCGTAT
CGGAGCTAGAGCCTCTCAT -> GGAGCTAGAGCCTCTCATA
CGGAGGGTCCGTTGACCGA -> GGAGGGTCCGTTGACCGAC
CGGAGGTGCGCGACAATAG -> GGAGGTGCGCGACAATAGG
CGGATATGAGCGTCATATC -> GGATATGAGCGTCATATCT
CGGATTAGCCGGTGAGTAG -> GGATTAGCCGGTGAGTAGG
CGGCAGCATTTGTTCAAAA -> GGCAGCATTTGTTCAAAAT
CGGCGAACCTTTTGGGTTT -> GGCGAACCTTTTGGGTTTT
CGGCTGTCCCCACCTATCG -> GGCTGTCCCCACCTATCGT
CGGGACTGCTGACGCCGTG -> GGGACTGCTGACGCCGTGT
CGGGCAGTTCAGGCTAAAC -> GGGCAGTTCAGGCTAAACA
CGGGCCAGTCAAGATGTCT -> GGGCCAGTCAAGATGTCTG
CGGGCCCTGCGGGCCAGTC -> GGGCCCTGCGGGCCAGTCA
CGGGTGCGATGATGGGTCA -> GGGTGCGATGATGGGTCAA
CGGGTGTTGTACCCGACGG -> GGGTGTTGTACCCGACGGA
CGGGTTACCGACCCGGTGA -> GGGTTACCGACCCGGTGAT
CGGGTTACCGCAGTCGTAA -> GGGTTACCGCAGTCGTAAA
CGGTAAATAGAGCTACTAC -> GGTAAATAGAGCTACTACG
CGGTAATTGTGCAATGACC -> GGTAATTGTGCAATGACCA
CGGTAATTGTGCACCGTAG -> GGTAATTGTGCACCGTAGC
CGGTAATTGTGCAGGCTGT -> GGTAATTGTGCAGGCTGTG
CGGTAATTGTGCATACGAC -> GGTAATTGTGCATACGACG
CGGTCCGGGCCCTGCGGGC -> GGTCCGGGCCCTGCGGGCC
CGGTCCTGATTTCCGTCTC -> GGTCCTGATTTCCGTCTCC
CGGTGACTCTCTGGAGGCA -> GGTGACTCTCTGGAGGCAT
CGGTGAGTAGGACGCCGAT -> GGTGAGTAGGACGCCGATA
CGGTGATCGGTCCGGGCCC -> GGTGATCGGTCCGGGCCCT
CGGTGATGGCTATCGTAGT -> GGTGATGGCTATCGTAGTA
CGGTTGGACCGATGAGTGC -> GGTTGGACCGATGAGTGCA
CGGTTTCAATCCTAGTGAC -> GGTTTCAATCCTAGTGACA
CGGTTTCATGCCGCCTTTC -> GGTTTCATGCCGCCTTTCT
CGTAAACCGCGCGGTTTCA -> GTAAACCGCGCGGTTTCAA
CGTAAAGGCTAGAACAACA -> GTAAAGGCTAGAACAACAA
CGTAACCTGAGTTCGGACC -> GTAACCTGAGTTCGGACCG
CGTAGCATGTAGCCGACCA -> GTAGCATGTAGCCGACCAA
CGTAGTAAGTCGAATCGAC -> GTAGTAAGTCGAATCGACT
CGTATATGATGGCTGTGGC -> GTATATGATGGCTGTGGCC
CGTATGTAATTGAACATAT -> GTATGTAATTGAACATATT
CGTATGTCCACTCACAATC -> GTATGTCCACTCACAATCG
CGTATGTCTTCGCAGGGAT -> GTATGTCTTCGCAGGGATG
CGTATGTGACATAATATAG -> GTATGTGACATAATATAGC
CGTCACTAGACTGCGTAAC -> GTCACTAGACTGCGTAACC
CGTCACTGCCAGTATCTTG -> GTCACTGCCAGTATCTTGT
CGTCAGAGGTAGGGAGGTG -> GTCAGAGGTAGGGAGGTGA
CGTCATATCTCTTGGATAG -> GTCATATCTCTTGGATAGG
CGTCGAAGAGAAAAACCGC -> GTCGAAGAGAAAAACCGCC
CGTCTCCTGTATACGCCCG -> GTCTCCTGTATACGCCCGG
CGTCTGGTATTGCTGCCAT -> GTCTGGTATTGCTGCCATG
CGTGGTACCCGACCGGCGA -> GTGGTACCCGACCGGCGAA
CGTGTACGAGAGATTTTAT -> GTGTACGAGAGATTTTATA
CGTGTACTCTTGAAGAGTA -> GTGTACTCTTGAAGAGTAT
CGTGTCCGCAACGACTCTT -> GTGTCCGCAACGACTCTTA
CGTGTTCACGCATTGATAA -> GTGTTCACGCATTGATAAA
CGTGTTTATAATTCGTTAC -> GTGTTTATAATTCGTTACC
CGTTACCAAAAAAATAACA -> GTTACCAAAAAAATAACAT
CGTTACTCGTGTACGAGAG -> GTTACTCGTGTACGAGAGA
CGTTCCCAATACGGTAAAT -> GTTCCCAATACGGTAAATA
CGTTGACCGACAGTTATAC -> GTTGACCGACAGTTATACC
CGTTGTCACCTGAATTCGG -> GTTGTCACCTGAATTCGGT
CGTTGTTCTTTATTGGTAA -> GTTGTTCTTTATTGGTAAG
CGTTTGTATCAGGGGATTA -> GTTTGTATCAGGGGATTAA
CTAAAACGCTGCAACCAGG -> TAAAACGCTGCAACCAGGA
CTAAACATAAAGCTGGAAC -> TAAACATAAAGCTGGAACG
CTAAGCTGAATGTCGATAA -> TAAGCTGAATGTCGATAAC
CTAAGTGCATTGCGTTGTC -> TAAGTGCATTGCGTTGTCA
CTAATACAGCAGACCCCAC -> TAATACAGCAGACCCCACA
CTAATTGGACCAGTTCATG -> TAATTGGACCAGTTCATGG
CTACAGAAATGTATAAAGG -> TACAGAAATGTATAAAGGT
CTACGATTTGAACCCCGAC -> TACGATTTGAACCCCGACT
CTACGCTAAAACGCTGCAA -> TACGCTAAAACGCTGCAAC
CTACGGGTGTTGTACCCGA -> TACGGGTGTTGTACCCGAC
CTACTACGCTAAAACGCTG -> TACTACGCTAAAACGCTGC
CTACTCTCAAACTAATTGG -> TACTCTCAAACTAATTGGA
CTAGAACAACAACGCCCTG -> TAGAACAACAACGCCCTGC
CTAGAAGCAAAATGAGACC -> TAGAAGCAAAATGAGACCA
CTAGACTGCGTAACCTGAG -> TAGACTGCGTAACCTGAGT
CTAGAGCCTCTCATAGTAC -> TAGAGCCTCTCATAGTACG
CTAGCCGACCAAAGCGTAT -> TAGCCGACCAAAGCGTATG
CTAGTGACACAAAACGACG -> TAGTGACACAAAACGACGA
CTAGTGACGTGTACTCTTG -> TAGTGACGTGTACTCTTGA
CTATATTTGACCGCGCAGC -> TATATTTGACCGCGCAGCA
CTATCGTAGTAAGTCGAAT -> TATCGTAGTAAGTCGAATC
CTATCGTCACTGCCAGTAT -> TATCGTCACTGCCAGTATC
CTATTAGTATATCCCGGCA -> TATTAGTATATCCCGGCAG
CTATTCCAACCTTCCCCGT -> TATTCCAACCTTCCCCGTT
CTATTTGGACGGCTGTCCC -> TATTTGGACGGCTGTCCCC
CTATTTTAACTCGAATCCC -> TATTTTAACTCGAATCCCC
CTCAAACTAATTGGACCAG -> TCAAACTAATTGGACCAGT
CTCAACCCGGGCAGTTCAG -> TCAACCCGGGCAGTTCAGG
CTCACAATCGCGCGTATAT -> TCACAATCGCGCGTATATG
CTCATAGTACGTAAAGGCT -> TCATAGTACGTAAAGGCTA
CTCATCGGTCCTGATTTCC -> TCATCGGTCCTGATTTCCG
CTCCAACCCCCATAGAGCA -> TCCAACCCCCATAGAGCAC
CTCCACAGTGATTGATACT -> TCCACAGTGATTGATACTT
CTCCCATACAACTTCACTC -> TCCCATACAACTTCACTCA
CTCCGGAGGGTCCGTTGAC -> TCCGGAGGGTCCGTTGACC
CTCCTGTATACGCCCGGGA -> TCCTGTATACGCCCGGGAC
CTCCTGTCCTCGGGTTACC -> TCCTGTCCTCGGGTTACCG
CTCGAATCCCCTTTCCTAT -> TCGAATCCCCTTTCCTATT
CTCGCCCCGAGTTGAACAA -> TCGCCCCGAGTTGAACAAG
CTCGGGTTACCGCAGTCGT -> TCGGGTTACCGCAGTCGTA
CTCGGTGATCGGTCCGGGC -> TCGGTGATCGGTCCGGGCC
CTCGGTTGGACCGATGAGT -> TCGGTTGGACCGATGAGTG
CTCGTGTACGAGAGATTTT -> TCGTGTACGAGAGATTTTA
CTCTCAAACTAATTGGACC -> TCTCAAACTAATTGGACCA
CTCTCATAGTACGTAAAGG -> TCTCATAGTACGTAAAGGC
CTCTCTGCAGTCGGACAAT -> TCTCTGCAGTCGGACAATG
CTCTCTGGAGGCATGAAGC -> TCTCTGGAGGCATGAAGCT
CTCTGCAGTCGGACAATGG -> TCTGCAGTCGGACAATGGG
CTCTGGAGACGCTGGCCCT -> TCTGGAGACGCTGGCCCTG
CTCTGGAGGCATGAAGCTC -> TCTGGAGGCATGAAGCTCC
CTCTGGCCTTTAGAGTCCT -> TCTGGCCTTTAGAGTCCTA
CTCTTATTTGAAGACAGGG -> TCTTATTTGAAGACAGGGA
CTCTTGAAGAGTATTTCAT -> TCTTGAAGAGTATTTCATA
CTCTTGGATAGGTGAAAGC -> TCTTGGATAGGTGAAAGCC
CTGAAGGGATGAGGCACTG -> TGAAGGGATGAGGCACTGT
CTGAATGTCGATAACCGAT -> TGAATGTCGATAACCGATA
CTGAATTCGGTGACTCTCT -> TGAATTCGGTGACTCTCTG
CTGACCCCCTTACAATGTC -> TGACCCCCTTACAATGTCG
CTGACGCCGTGTTTATAAT -> TGACGCCGTGTTTATAATT
CTGAGTTCGGACCGCTATA -> TGAGTTCGGACCGCTATAT
CTGATTTCCGTCTCCTGTA -> TGATTTCCGTCTCCTGTAT
CTGCAACCAGGATGGCTCG -> TGCAACCAGGATGGCTCGG
CTGCAGTCGGACAATGGGG -> TGCAGTCGGACAATGGGGT
CTGCCAGTATCTTGTTTTG -> TGCCAGTATCTTGTTTTGT
CTGCCATGGCTGTAACACG -> TGCCATGGCTGTAACACGG
CTGCGGAGGTGCGCGACAA -> TGCGGAGGTGCGCGACAAT
CTGCGGGCCAGTCAAGATG -> TGCGGGCCAGTCAAGATGT
CTGCGTAACCTGAGTTCGG -> TGCGTAACCTGAGTTCGGA
CTGCTGACGCCGTGTTTAT -> TGCTGACGCCGTGTTTATA
CTGGAACGCTACGGGTGTT -> TGGAACGCTACGGGTGTTG
CTGGAGACGCTGGCCCTGT -> TGGAGACGCTGGCCCTGTA
CTGGAGGCATGAAGCTCCG -> TGGAGGCATGAAGCTCCGG
CTGGCCCTGTACGGTAATT -> TGGCCCTGTACGGTAATTG
CTGGCCTCTCTGCAGTCGG -> TGGCCTCTCTGCAGTCGGA
CTGGCCTTTAGAGTCCTAC -> TGGCCTTTAGAGTCCTACT
CTGGCTGGGCATGAAGCCC -> TGGCTGGGCATGAAGCCCA
CTGGGAGTGCGTGTCCGCA -> TGGGAGTGCGTGTCCGCAA
CTGGGCATGAAGCCCAACG -> TGGGCATGAAGCCCAACGG
CTGGTATTGCTGCCATGGC -> TGGTATTGCTGCCATGGCT
CTGGTGGTTCCTGTGGGGG -> TGGTGGTTCCTGTGGGGGC
CTGTAACACGGAAGGAATG -> TGTAACACGGAAGGAATGC
CTGTACGGTAATTGTGCAA -> TGTACGGTAATTGTGCAAT
CTGTACGGTAATTGTGCAC -> TGTACGGTAATTGTGCACC
CTGTACGGTAATTGTGCAG -> TGTACGGTAATTGTGCAGG
CTGTACGGTAATTGTGCAT -> TGTACGGTAATTGTGCATA
CTGTATACGCCCGGGACTG -> TGTATACGCCCGGGACTGC
CTGTCCCCACCTATCGTCA -> TGTCCCCACCTATCGTCAC
CTGTCCTCGGGTTACCGCA -> TGTCCTCGGGTTACCGCAG
CTGTCGCTCCCATACAACT -> TGTCGCTCCCATACAACTT
CTGTCGGTTTCATGCCGCC -> TGTCGGTTTCATGCCGCCT
CTGTCTAGTGACGTGTACT -> TGTCTAGTGACGTGTACTC
CTGTGACGGAGCCGACCAA -> TGTGACGGAGCCGACCAAA
CTGTGGCCGAACACAGGCG -> TGTGGCCGAACACAGGCGG
CTGTGGGGGCAGCCGACCG -> TGTGGGGGCAGCCGACCGA
CTTAATGAGGTTGGGATGG -> TTAATGAGGTTGGGATGGA
CTTACAATGTCGGATATGA -> TTACAATGTCGGATATGAG
CTTACCTGGCTGGGCATGA -> TTACCTGGCTGGGCATGAA
CTTAGGCTGTACGGTAATT -> TTAGGCTGTACGGTAATTG
CTTATTTGAAGACAGGGAT -> TTATTTGAAGACAGGGATA
CTTCACTCAGCTATAAGAG -> TTCACTCAGCTATAAGAGT
CTTCCCCGTTCCCAATACG -> TTCCCCGTTCCCAATACGG
CTTCCGAGTTTTCGAGATA -> TTCCGAGTTTTCGAGATAC
CTTCGCAGGGATGGGATTT -> TTCGCAGGGATGGGATTTA
CTTGAAGAGTATTTCATAG -> TTGAAGAGTATTTCATAGC
CTTGATCAATCGATACGAT -> TTGATCAATCGATACGATG
CTTGGATAGGTGAAAGCCG -> TTGGATAGGTGAAAGCCGC
CTTGTTTTGTGGAAGATGT -> TTGTTTTGTGGAAGATGTA
CTTTAGAGTCCTACTCTCA -> TTTAGAGTCCTACTCTCAA
CTTTATTGGTAAGTCATAG -> TTTATTGGTAAGTCATAGA
CTTTCCTATTTGGACGGCT -> TTTCCTATTTGGACGGCTG
CTTTCTTACCTGGCTGGGC -> TTTCTTACCTGGCTGGGCA
CTTTGAGCACATACCGCTC -> TTTGAGCACATACCGCTCA
CTTTTGGGTTTTAGGTTGT -> TTTTGGGTTTTAGGTTGTG
CTTTTTGATAAGTTGTCAT -> TTTTTGATAAGTTGTCATA
GAAAAACCGCCTCCACAGT -> AAAAACCGCCTCCACAGTG
GAAAGCCGCAACCATAGTG -> AAAGCCGCAACCATAGTGT
GAAATGTATAAAGGTTCGC -> AAATGTATAAAGGTTCGCC
GAACAACAACGCCCTGCGG -> AACAACAACGCCCTGCGGA
GAACAAGTGACGTCGAAGA -> AACAAGTGACGTCGAAGAG
GAACACAGGCGGAGCTAGA -> AACACAGGCGGAGCTAGAG
GAACATATTCATACACCGA -> AACATATTCATACACCGAG
GAACCCCGACTGAAGGGAT -> AACCCCGACTGAAGGGATG
GAACCTTTTGGGTTTTAGG -> AACCTTTTGGGTTTTAGGT
GAACGCTACGGGTGTTGTA -> AACGCTACGGGTGTTGTAC
GAAGACAGGGATAAGCAGC -> AAGACAGGGATAAGCAGCA
GAAGAGAAAAACCGCCTCC -> AAGAGAAAAACCGCCTCCA
GAAGAGGAAGGCCAAACTT -> AAGAGGAAGGCCAAACTTT
GAAGAGTATTTCATAGCTA -> AAGAGTATTTCATAGCTAC
GAAGATGTATAACCTCTGG -> AAGATGTATAACCTCTGGC
GAAGCAAAATGAGACCAGG -> AAGCAAAATGAGACCAGGG
GAAGCCCAACGGGTGCGAT -> AAGCCCAACGGGTGCGATG
GAAGCCGACCAAAGCGTAT -> AAGCCGACCAAAGCGTATG
GAAGCTCCGGAGGGTCCGT -> AAGCTCCGGAGGGTCCGTT
GAAGGAATGCCGCACAACC -> AAGGAATGCCGCACAACCT
GAAGGCCAAACTTTTTGAT -> AAGGCCAAACTTTTTGATA
GAAGGGATGAGGCACTGTA -> AAGGGATGAGGCACTGTAC
GAAGTTAACATCTTGATCA -> AAGTTAACATCTTGATCAA
GAATCCCCTTTCCTATTTG -> AATCCCCTTTCCTATTTGG
GAATCGACTTAATGAGGTT -> AATCGACTTAATGAGGTTG
GAATGCCGCACAACCTCGC -> AATGCCGCACAACCTCGCC
GAATGTCGATAACCGATAT -> AATGTCGATAACCGATATC
GAATTCGGTGACTCTCTGG -> AATTCGGTGACTCTCTGGA
GAATTTCGAGTGGCAAAGG -> AATTTCGAGTGGCAAAGGA
GACAAGATAAGTTCAAGTC -> ACAAGATAAGTTCAAGTCC
GACAATAGGGCCTGGGAGT -> ACAATAGGGCCTGGGAGTG
GACAATGGGGTTGTTCGTT -> ACAATGGGGTTGTTCGTTT
GACACAAAACGACGAGAGC -> ACACAAAACGACGAGAGCT
GACAGGGATAAGCAGCATG -> ACAGGGATAAGCAGCATGT
GACAGTTATACCAGGTCCT -> ACAGTTATACCAGGTCCTA
GACATAATATAGCCATCTA -> ACATAATATAGCCATCTAA
GACATCCAAATACCGAGCC -> ACATCCAAATACCGAGCCA
GACCAAAGCGTATGTAATT -> ACCAAAGCGTATGTAATTG
GACCAAAGCGTATGTCCAC -> ACCAAAGCGTATGTCCACT
GACCAAAGCGTATGTCTTC -> ACCAAAGCGTATGTCTTCG
GACCAAAGCGTATGTGACA -> ACCAAAGCGTATGTGACAT
GACCAGAGAAGCCGACCAA -> ACCAGAGAAGCCGACCAAA
GACCAGGGCTAATACAGCA -> ACCAGGGCTAATACAGCAG
GACCAGTTCATGGAAGAGG -> ACCAGTTCATGGAAGAGGA
GACCCATAAAACTCCTGTC -> ACCCATAAAACTCCTGTCC
GACCCCACACGTTACTCGT -> ACCCCACACGTTACTCGTG
GACCCCCTTACAATGTCGG -> ACCCCCTTACAATGTCGGA
GACCCGGTGATGGCTATCG -> ACCCGGTGATGGCTATCGT
GACCCTATTAGTATATCCC -> ACCCTATTAGTATATCCCG
GACCGACAGTTATACCAGG -> ACCGACAGTTATACCAGGT
GACCGATAGACAAGATAAG -> ACCGATAGACAAGATAAGT
GACCGATGAGTGCAACAAC -> ACCGATGAGTGCAACAACA
GACCGCGCAGCAGGAGCTG -> ACCGCGCAGCAGGAGCTGT
GACCGCTATATTTGACCGC -> ACCGCTATATTTGACCGCG
GACCGGCGAACCTTTTGGG -> ACCGGCGAACCTTTTGGGT
GACCTAGCCGACCAAAGCG -> ACCTAGCCGACCAAAGCGT
GACGACCTAGCCGACCAAA -> ACGACCTAGCCGACCAAAG
GACGAGAGCTCAACCCGGG -> ACGAGAGCTCAACCCGGGC
GACGCACGTCAGAGGTAGG -> ACGCACGTCAGAGGTAGGG
GACGCCGATATAACTATTC -> ACGCCGATATAACTATTCC
GACGCCGTGTTTATAATTC -> ACGCCGTGTTTATAATTCG
GACGCTGGCCCTGTACGGT -> ACGCTGGCCCTGTACGGTA
GACGGAGCCGACCAAAGCG -> ACGGAGCCGACCAAAGCGT
GACGGATTAGCCGGTGAGT -> ACGGATTAGCCGGTGAGTA
GACGGCTGTCCCCACCTAT -> ACGGCTGTCCCCACCTATC
GACGTCACTAGACTGCGTA -> ACGTCACTAGACTGCGTAA
GACGTCGAAGAGAAAAACC -> ACGTCGAAGAGAAAAACCG
GACGTGTACTCTTGAAGAG -> ACGTGTACTCTTGAAGAGT
GACTCTCTGGAGGCATGAA -> ACTCTCTGGAGGCATGAAG
GACTCTTATTTGAAGACAG -> ACTCTTATTTGAAGACAGG
GACTGAAGGGATGAGGCAC -> ACTGAAGGGATGAGGCACT
GACTGCGTAACCTGAGTTC -> ACTGCGTAACCTGAGTTCG
GACTGCTGACGCCGTGTTT -> ACTGCTGACGCCGTGTTTA
GACTTAATGAGGTTGGGAT -> ACTTAATGAGGTTGGGATG
GACTTTGAGCACATACCGC -> ACTTTGAGCACATACCGCT
GAGAAAAACCGCCTCCACA -> AGAAAAACCGCCTCCACAG
GAGAAGCCGACCAAAGCGT -> AGAAGCCGACCAAAGCGTA
GAGACCAGGGCTAATACAG -> AGACCAGGGCTAATACAGC
GAGACGCTGGCCCTGTACG -> AGACGCTGGCCCTGTACGG
GAGAGATTTTATACTGGTG -> AGAGATTTTATACTGGTGG
GAGAGCTCAACCCGGGCAG -> AGAGCTCAACCCGGGCAGT
GAGATACAGGTCTCTGGAG -> AGATACAGGTCTCTGGAGA
GAGATTTTATACTGGTGGT -> AGATTTTATACTGGTGGTT
GAGCACATACCGCTCATCG -> AGCACATACCGCTCATCGG
GAGCACCTCGGTGATCGGT -> AGCACCTCGGTGATCGGTC
GAGCACGCGCGACCCTATT -> AGCACGCGCGACCCTATTA
GAGCCAATATTGAGGATGC -> AGCCAATATTGAGGATGCA
GAGCCGACCAAAGCGTATG -> AGCCGACCAAAGCGTATGT
GAGCCTCTCATAGTACGTA -> AGCCTCTCATAGTACGTAA
GAGCGTCATATCTCTTGGA -> AGCGTCATATCTCTTGGAT
GAGCTACTACGCTAAAACG -> AGCTACTACGCTAAAACGC
GAGCTAGAGCCTCTCATAG -> AGCTAGAGCCTCTCATAGT
GAGCTATTTTAACTCGAAT -> AGCTATTTTAACTCGAATC
GAGCTCAACCCGGGCAGTT -> AGCTCAACCCGGGCAGTTC
GAGCTCCAACCCCCATAGA -> AGCTCCAACCCCCATAGAG
GAGCTGTCGGTTTCATGCC -> AGCTGTCGGTTTCATGCCG
GAGGAAGGCCAAACTTTTT -> AGGAAGGCCAAACTTTTTG
GAGGATGCACCATGTGGGG -> AGGATGCACCATGTGGGGC
GAGGCACTGTACGGTAATT -> AGGCACTGTACGGTAATTG
GAGGCATGAAGCTCCGGAG -> AGGCATGAAGCTCCGGAGG
GAGGGATTCGTCTGGTATT -> AGGGATTCGTCTGGTATTG
GAGGGTCCGTTGACCGACA -> AGGGTCCGTTGACCGACAG
GAGGTAGGGAGGTGAGGGA -> AGGTAGGGAGGTGAGGGAT
GAGGTGAGGGATTCGTCTG -> AGGTGAGGGATTCGTCTGG
GAGGTGCGCGACAATAGGG -> AGGTGCGCGACAATAGGGC
GAGGTTGGGATGGATTGGT -> AGGTTGGGATGGATTGGTG
GAGTAGGACGCCGATATAA -> AGTAGGACGCCGATATAAC
GAGTATTTCATAGCTACGA -> AGTATTTCATAGCTACGAT
GAGTCCTACTCTCAAACTA -> AGTCCTACTCTCAAACTAA
GAGTGACGCACGTCAGAGG -> AGTGACGCACGTCAGAGGT
GAGTGCAACAACAGACGTC -> AGTGCAACAACAGACGTCA
GAGTGCGTGTCCGCAACGA -> AGTGCGTGTCCGCAACGAC
GAGTGGCAAAGGACATCCA -> AGTGGCAAAGGACATCCAA
GAGTTCGGACCGCTATATT -> AGTTCGGACCGCTATATTT
GAGTTGAACAAGTGACGTC -> AGTTGAACAAGTGACGTCG
GAGTTTTCGAGATACAGGT -> AGTTTTCGAGATACAGGTC
GATAAATCGAGCACCTCGG -> ATAAATCGAGCACCTCGGT
GATAACCGATATCTGTACG -> ATAACCGATATCTGTACGG
GATAAGCAGCATGTTTCAT -> ATAAGCAGCATGTTTCATC
GATAAGTTCAAGTCCTGAC -> ATAAGTTCAAGTCCTGACC
GATAAGTTGTCATATTACA -> ATAAGTTGTCATATTACAT
GATACAGGTCTCTGGAGAC -> ATACAGGTCTCTGGAGACG
GATACGATGGTCTACAGAA -> ATACGATGGTCTACAGAAA
GATACTTAGGCTGTACGGT -> ATACTTAGGCTGTACGGTA
GATAGACAAGATAAGTTCA -> ATAGACAAGATAAGTTCAA
GATAGGTGAAAGCCGCAAC -> ATAGGTGAAAGCCGCAACC
GATATAACTATTCCAACCT -> ATATAACTATTCCAACCTT
GATATCTGTACGGTAATTG -> ATATCTGTACGGTAATTGT
GATATGAGCGTCATATCTC -> ATATGAGCGTCATATCTCT
GATCAATCGATACGATGGT -> ATCAATCGATACGATGGTC
GATCGGTCCGGGCCCTGCG -> ATCGGTCCGGGCCCTGCGG
GATGAGGCACTGTACGGTA -> ATGAGGCACTGTACGGTAA
GATGAGTGCAACAACAGAC -> ATGAGTGCAACAACAGACG
GATGATGGGTCAACCATGA -> ATGATGGGTCAACCATGAA
GATGCACCATGTGGGGCAA -> ATGCACCATGTGGGGCAAC
GATGGATTGGTGGCTGGCC -> ATGGATTGGTGGCTGGCCT
GATGGCTATCGTAGTAAGT -> ATGGCTATCGTAGTAAGTC
GATGGCTCGGTTGGACCGA -> ATGGCTCGGTTGGACCGAT
GATGGCTGTGGCCGAACAC -> ATGGCTGTGGCCGAACACA
GATGGGATTTAAACGGGTT -> ATGGGATTTAAACGGGTTA
GATGGGTCAACCATGAAGT -> ATGGGTCAACCATGAAGTT
GATGGTCTACAGAAATGTA -> ATGGTCTACAGAAATGTAT
GATGTATAACCTCTGGCCT -> ATGTATAACCTCTGGCCTT
GATGTCTGTCGCTCCCATA -> ATGTCTGTCGCTCCCATAC
GATTAAAATACCGCCCAGA -> ATTAAAATACCGCCCAGAA
GATTAGCCGGTGAGTAGGA -> ATTAGCCGGTGAGTAGGAC
GATTCGTCTGGTATTGCTG -> ATTCGTCTGGTATTGCTGC
GATTGATACTTAGGCTGTA -> ATTGATACTTAGGCTGTAC
GATTGGTGGCTGGCCTCTC -> ATTGGTGGCTGGCCTCTCT
GATTTAAACGGGTTACCGA -> ATTTAAACGGGTTACCGAC
GATTTCCGTCTCCTGTATA -> ATTTCCGTCTCCTGTATAC
GATTTGAACCCCGACTGAA -> ATTTGAACCCCGACTGAAG
GATTTTATACTGGTGGTTC -> ATTTTATACTGGTGGTTCC
GCAAAATGAGACCAGGGCT -> CAAAATGAGACCAGGGCTA
GCAAAGGACATCCAAATAC -> CAAAGGACATCCAAATACC
GCAACAACAGACGTCACTA -> CAACAACAGACGTCACTAG
GCAACCAGGATGGCTCGGT -> CAACCAGGATGGCTCGGTT
GCAACCATAGTGTCGTGGT -> CAACCATAGTGTCGTGGTA
GCAACGACTCTTATTTGAA -> CAACGACTCTTATTTGAAG
GCAACGTTGTTCTTTATTG -> CAACGTTGTTCTTTATTGG
GCAATGACCAGAGAAGCCG -> CAATGACCAGAGAAGCCGA
GCACAACCTCGCCCCGAGT -> CACAACCTCGCCCCGAGTT
GCACATACCGCTCATCGGT -> CACATACCGCTCATCGGTC
GCACCATGTGGGGCAACGT -> CACCATGTGGGGCAACGTT
GCACCGTAGCATGTAGCCG -> CACCGTAGCATGTAGCCGA
GCACCTCGGTGATCGGTCC -> CACCTCGGTGATCGGTCCG
GCACGCGCGACCCTATTAG -> CACGCGCGACCCTATTAGT
GCACGTCAGAGGTAGGGAG -> CACGTCAGAGGTAGGGAGG
GCACTGTACGGTAATTGTG -> CACTGTACGGTAATTGTGC
GCAGACCCCACACGTTACT -> CAGACCCCACACGTTACTC
GCAGCAGGAGCTGTCGGTT -> CAGCAGGAGCTGTCGGTTT
GCAGCATGTTTCATCTAAG -> CAGCATGTTTCATCTAAGT
GCAGCATTTGTTCAAAATG -> CAGCATTTGTTCAAAATGT
GCAGCCGACCGATAGACAA -> CAGCCGACCGATAGACAAG
GCAGGAGCTGTCGGTTTCA -> CAGGAGCTGTCGGTTTCAT
GCAGGCTGTGACGGAGCCG -> CAGGCTGTGACGGAGCCGA
GCAGGGATGGGATTTAAAC -> CAGGGATGGGATTTAAACG
GCAGTCGGACAATGGGGTT -> CAGTCGGACAATGGGGTTG
GCAGTCGTAAACCGCGCGG -> CAGTCGTAAACCGCGCGGT
GCAGTTCAGGCTAAACATA -> CAGTTCAGGCTAAACATAA
GCATACGACGACCTAGCCG -> CATACGACGACCTAGCCGA
GCATGAAGCCCAACGGGTG -> CATGAAGCCCAACGGGTGC
GCATGAAGCTCCGGAGGGT -> CATGAAGCTCCGGAGGGTC
GCATGTAGCCGACCAAAGC -> CATGTAGCCGACCAAAGCG
GCATGTTTCATCTAAGTGC -> CATGTTTCATCTAAGTGCA
GCATTGATAAATCGAGCAC -> CATTGATAAATCGAGCACC
GCATTGCGTTGTCACCTGA -> CATTGCGTTGTCACCTGAA
GCATTTGTTCAAAATGTAC -> CATTTGTTCAAAATGTACA
GCCAAACTTTTTGATAAGT -> CCAAACTTTTTGATAAGTT
GCCAATATTGAGGATGCAC -> CCAATATTGAGGATGCACC
GCCACACTTCCGAGTTTTC -> CCACACTTCCGAGTTTTCG
GCCAGTATCTTGTTTTGTG -> CCAGTATCTTGTTTTGTGG
GCCAGTCAAGATGTCTGTC -> CCAGTCAAGATGTCTGTCG
GCCATCTAAGCTGAATGTC -> CCATCTAAGCTGAATGTCG
GCCATGGCTGTAACACGGA -> CCATGGCTGTAACACGGAA
GCCCAACGGGTGCGATGAT -> CCCAACGGGTGCGATGATG
GCCCAGAATTTCGAGTGGC -> CCCAGAATTTCGAGTGGCA
GCCCCGAGTTGAACAAGTG -> CCCCGAGTTGAACAAGTGA
GCCCGGGACTGCTGACGCC -> CCCGGGACTGCTGACGCCG
GCCCTGCGGAGGTGCGCGA -> CCCTGCGGAGGTGCGCGAC
GCCCTGCGGGCCAGTCAAG -> CCCTGCGGGCCAGTCAAGA
GCCCTGTACGGTAATTGTG -> CCCTGTACGGTAATTGTGC
GCCGAACACAGGCGGAGCT -> CCGAACACAGGCGGAGCTA
GCCGACCAAAGCGTATGTA -> CCGACCAAAGCGTATGTAA
GCCGACCAAAGCGTATGTC -> CCGACCAAAGCGTATGTCC,CCGACCAAAGCGTATGTCT
GCCGACCAAAGCGTATGTG -> CCGACCAAAGCGTATGTGA
GCCGACCGATAGACAAGAT -> CCGACCGATAGACAAGATA
GCCGATATAACTATTCCAA -> CCGATATAACTATTCCAAC
GCCGCAACCATAGTGTCGT -> CCGCAACCATAGTGTCGTG
GCCGCACAACCTCGCCCCG -> CCGCACAACCTCGCCCCGA
GCCGCCTTTCTTACCTGGC -> CCGCCTTTCTTACCTGGCT
GCCGGTGAGTAGGACGCCG -> CCGGTGAGTAGGACGCCGA
GCCGTGTTTATAATTCGTT -> CCGTGTTTATAATTCGTTA
GCCTCCACAGTGATTGATA -> CCTCCACAGTGATTGATAC
GCCTCTCATAGTACGTAAA -> CCTCTCATAGTACGTAAAG
GCCTCTCTGCAGTCGGACA -> CCTCTCTGCAGTCGGACAA
GCCTGGGAGTGCGTGTCCG -> CCTGGGAGTGCGTGTCCGC
GCCTGTCTAGTGACGTGTA -> CCTGTCTAGTGACGTGTAC
GCCTTTAGAGTCCTACTCT -> CCTTTAGAGTCCTACTCTC
GCCTTTCTTACCTGGCTGG -> CCTTTCTTACCTGGCTGGG
GCGAACCTTTTGGGTTTTA -> CGAACCTTTTGGGTTTTAG
GCGACAATAGGGCCTGGGA -> CGACAATAGGGCCTGGGAG
GCGACCCTATTAGTATATC -> CGACCCTATTAGTATATCC
GCGATGATGGGTCAACCAT -> CGATGATGGGTCAACCATG
GCGCAGCAGGAGCTGTCGG -> CGCAGCAGGAGCTGTCGGT
GCGCGACAATAGGGCCTGG -> CGCGACAATAGGGCCTGGG
GCGCGACCCTATTAGTATA -> CGCGACCCTATTAGTATAT
GCGCGGTTTCAATCCTAGT -> CGCGGTTTCAATCCTAGTG
GCGCGTATATGATGGCTGT -> CGCGTATATGATGGCTGTG
GCGGAGCTAGAGCCTCTCA -> CGGAGCTAGAGCCTCTCAT
GCGGAGGTGCGCGACAATA -> CGGAGGTGCGCGACAATAG
GCGGGCCAGTCAAGATGTC -> CGGGCCAGTCAAGATGTCT
GCGGTTTCAATCCTAGTGA -> CGGTTTCAATCCTAGTGAC
GCGTAACCTGAGTTCGGAC -> CGTAACCTGAGTTCGGACC
GCGTATATGATGGCTGTGG -> CGTATATGATGGCTGTGGC
GCGTATGTAATTGAACATA -> CGTATGTAATTGAACATAT
GCGTATGTCCACTCACAAT -> CGTATGTCCACTCACAATC
GCGTATGTCTTCGCAGGGA -> CGTATGTCTTCGCAGGGAT
GCGTATGTGACATAATATA -> CGTATGTGACATAATATAG
GCGTCATATCTCTTGGATA -> CGTCATATCTCTTGGATAG
GCGTGTCCGCAACGACTCT -> CGTGTCCGCAACGACTCTT
GCGTTGTCACCTGAATTCG -> CGTTGTCACCTGAATTCGG
GCTAAAACGCTGCAACCAG -> CTAAAACGCTGCAACCAGG
GCTAAACATAAAGCTGGAA -> CTAAACATAAAGCTGGAAC
GCTAATACAGCAGACCCCA -> CTAATACAGCAGACCCCAC
GCTACGATTTGAACCCCGA -> CTACGATTTGAACCCCGAC
GCTACGGGTGTTGTACCCG -> CTACGGGTGTTGTACCCGA
GCTACTACGCTAAAACGCT -> CTACTACGCTAAAACGCTG
GCTAGAACAACAACGCCCT -> CTAGAACAACAACGCCCTG
GCTAGAGCCTCTCATAGTA -> CTAGAGCCTCTCATAGTAC
GCTATATTTGACCGCGCAG -> CTATATTTGACCGCGCAGC
GCTATCGTAGTAAGTCGAA -> CTATCGTAGTAAGTCGAAT
GCTATTTTAACTCGAATCC -> CTATTTTAACTCGAATCCC
GCTCAACCCGGGCAGTTCA -> CTCAACCCGGGCAGTTCAG
GCTCATCGGTCCTGATTTC -> CTCATCGGTCCTGATTTCC
GCTCCAACCCCCATAGAGC -> CTCCAACCCCCATAGAGCA
GCTCCCATACAACTTCACT -> CTCCCATACAACTTCACTC
GCTCCGGAGGGTCCGTTGA -> CTCCGGAGGGTCCGTTGAC
GCTCGGTTGGACCGATGAG -> CTCGGTTGGACCGATGAGT
GCTGAATGTCGATAACCGA -> CTGAATGTCGATAACCGAT
GCTGACGCCGTGTTTATAA -> CTGACGCCGTGTTTATAAT
GCTGCAACCAGGATGGCTC -> CTGCAACCAGGATGGCTCG
GCTGCCATGGCTGTAACAC -> CTGCCATGGCTGTAACACG
GCTGGAACGCTACGGGTGT -> CTGGAACGCTACGGGTGTT
GCTGGCCCTGTACGGTAAT -> CTGGCCCTGTACGGTAATT
GCTGGCCTCTCTGCAGTCG -> CTGGCCTCTCTGCAGTCGG
GCTGGGCATGAAGCCCAAC -> CTGGGCATGAAGCCCAACG
GCTGTAACACGGAAGGAAT -> CTGTAACACGGAAGGAATG
GCTGTACGGTAATTGTGCA -> CTGTACGGTAATTGTGCAG
GCTGTCCCCACCTATCGTC -> CTGTCCCCACCTATCGTCA
GCTGTCGGTTTCATGCCGC -> CTGTCGGTTTCATGCCGCC
GCTGTGACGGAGCCGACCA -> CTGTGACGGAGCCGACCAA
GCTGTGGCCGAACACAGGC -> CTGTGGCCGAACACAGGCG
GGAACGCTACGGGTGTTGT -> GAACGCTACGGGTGTTGTA
GGAAGAGGAAGGCCAAACT -> GAAGAGGAAGGCCAAACTT
GGAAGATGTATAACCTCTG -> GAAGATGTATAACCTCTGG
GGAAGGAATGCCGCACAAC -> GAAGGAATGCCGCACAACC
GGAAGGCCAAACTTTTTGA -> GAAGGCCAAACTTTTTGAT
GGAATGCCGCACAACCTCG -> GAATGCCGCACAACCTCGC
GGACAATGGGGTTGTTCGT -> GACAATGGGGTTGTTCGTT
GGACATCCAAATACCGAGC -> GACATCCAAATACCGAGCC
GGACCAGTTCATGGAAGAG -> GACCAGTTCATGGAAGAGG
GGACCGATGAGTGCAACAA -> GACCGATGAGTGCAACAAC
GGACCGCTATATTTGACCG -> GACCGCTATATTTGACCGC
GGACGCCGATATAACTATT -> GACGCCGATATAACTATTC
GGACGGCTGTCCCCACCTA -> GACGGCTGTCCCCACCTAT
GGACTGCTGACGCCGTGTT -> GACTGCTGACGCCGTGTTT
GGAGACGCTGGCCCTGTAC -> GAGACGCTGGCCCTGTACG
GGAGCCGACCAAAGCGTAT -> GAGCCGACCAAAGCGTATG
GGAGCTAGAGCCTCTCATA -> GAGCTAGAGCCTCTCATAG
GGAGCTGTCGGTTTCATGC -> GAGCTGTCGGTTTCATGCC
GGAGGCATGAAGCTCCGGA -> GAGGCATGAAGCTCCGGAG
GGAGGGTCCGTTGACCGAC -> GAGGGTCCGTTGACCGACA
GGAGGTGAGGGATTCGTCT -> GAGGTGAGGGATTCGTCTG
GGAGGTGCGCGACAATAGG -> GAGGTGCGCGACAATAGGG
GGAGTGCGTGTCCGCAACG -> GAGTGCGTGTCCGCAACGA
GGATAAGCAGCATGTTTCA -> GATAAGCAGCATGTTTCAT
GGATAGGTGAAAGCCGCAA -> GATAGGTGAAAGCCGCAAC
GGATATGAGCGTCATATCT -> GATATGAGCGTCATATCTC
GGATGAGGCACTGTACGGT -> GATGAGGCACTGTACGGTA
GGATGCACCATGTGGGGCA -> GATGCACCATGTGGGGCAA
GGATGGATTGGTGGCTGGC -> GATGGATTGGTGGCTGGCC
GGATGGCTCGGTTGGACCG -> GATGGCTCGGTTGGACCGA
GGATGGGATTTAAACGGGT -> GATGGGATTTAAACGGGTT
GGATTAAAATACCGCCCAG -> GATTAAAATACCGCCCAGA
GGATTAGCCGGTGAGTAGG -> GATTAGCCGGTGAGTAGGA
GGATTCGTCTGGTATTGCT -> GATTCGTCTGGTATTGCTG
GGATTGGTGGCTGGCCTCT -> GATTGGTGGCTGGCCTCTC
GGATTTAAACGGGTTACCG -> GATTTAAACGGGTTACCGA
GGCAAAGGACATCCAAATA -> GCAAAGGACATCCAAATAC
GGCAACGTTGTTCTTTATT -> GCAACGTTGTTCTTTATTG
GGCACTGTACGGTAATTGT -> GCACTGTACGGTAATTGTG
GGCAGCATTTGTTCAAAAT -> GCAGCATTTGTTCAAAATG
GGCAGCCGACCGATAGACA -> GCAGCCGACCGATAGACAA
GGCAGTTCAGGCTAAACAT -> GCAGTTCAGGCTAAACATA
GGCATGAAGCCCAACGGGT -> GCATGAAGCCCAACGGGTG
GGCATGAAGCTCCGGAGGG -> GCATGAAGCTCCGGAGGGT
GGCCAAACTTTTTGATAAG -> GCCAAACTTTTTGATAAGT
GGCCAGTCAAGATGTCTGT -> GCCAGTCAAGATGTCTGTC
GGCCCTGCGGGCCAGTCAA -> GCCCTGCGGGCCAGTCAAG
GGCCCTGTACGGTAATTGT -> GCCCTGTACGGTAATTGTG
GGCCGAACACAGGCGGAGC -> GCCGAACACAGGCGGAGCT
GGCCTCTCTGCAGTCGGAC -> GCCTCTCTGCAGTCGGACA
GGCCTGGGAGTGCGTGTCC -> GCCTGGGAGTGCGTGTCCG
GGCCTTTAGAGTCCTACTC -> GCCTTTAGAGTCCTACTCT
GGCGAACCTTTTGGGTTTT -> GCGAACCTTTTGGGTTTTA
GGCGGAGCTAGAGCCTCTC -> GCGGAGCTAGAGCCTCTCA
GGCTAAACATAAAGCTGGA -> GCTAAACATAAAGCTGGAA
GGCTAATACAGCAGACCCC -> GCTAATACAGCAGACCCCA
GGCTAGAACAACAACGCCC -> GCTAGAACAACAACGCCCT
GGCTATCGTAGTAAGTCGA -> GCTATCGTAGTAAGTCGAA
GGCTCGGTTGGACCGATGA -> GCTCGGTTGGACCGATGAG
GGCTGGCCTCTCTGCAGTC -> GCTGGCCTCTCTGCAGTCG
GGCTGGGCATGAAGCCCAA -> GCTGGGCATGAAGCCCAAC
GGCTGTAACACGGAAGGAA -> GCTGTAACACGGAAGGAAT
GGCTGTACGGTAATTGTGC -> GCTGTACGGTAATTGTGCA
GGCTGTCCCCACCTATCGT -> GCTGTCCCCACCTATCGTC
GGCTGTGACGGAGCCGACC -> GCTGTGACGGAGCCGACCA
GGCTGTGGCCGAACACAGG -> GCTGTGGCCGAACACAGGC
GGGACTGCTGACGCCGTGT -> GGACTGCTGACGCCGTGTT
GGGAGGTGAGGGATTCGTC -> GGAGGTGAGGGATTCGTCT
GGGAGTGCGTGTCCGCAAC -> GGAGTGCGTGTCCGCAACG
GGGATAAGCAGCATGTTTC -> GGATAAGCAGCATGTTTCA
GGGATGAGGCACTGTACGG -> GGATGAGGCACTGTACGGT
GGGATGGATTGGTGGCTGG -> GGATGGATTGGTGGCTGGC
GGGATGGGATTTAAACGGG -> GGATGGGATTTAAACGGGT
GGGATTAAAATACCGCCCA -> GGATTAAAATACCGCCCAG
GGGATTCGTCTGGTATTGC -> GGATTCGTCTGGTATTGCT
GGGATTTAAACGGGTTACC -> GGATTTAAACGGGTTACCG
GGGCAACGTTGTTCTTTAT -> GGCAACGTTGTTCTTTATT
GGGCAGCCGACCGATAGAC -> GGCAGCCGACCGATAGACA
GGGCAGTTCAGGCTAAACA -> GGCAGTTCAGGCTAAACAT
GGGCATGAAGCCCAACGGG -> GGCATGAAGCCCAACGGGT
GGGCCAGTCAAGATGTCTG -> GGCCAGTCAAGATGTCTGT
GGGCCCTGCGGGCCAGTCA -> GGCCCTGCGGGCCAGTCAA
GGGCCTGGGAGTGCGTGTC -> GGCCTGGGAGTGCGTGTCC
GGGCTAATACAGCAGACCC -> GGCTAATACAGCAGACCCC
GGGGATTAAAATACCGCCC -> GGGATTAAAATACCGCCCA
GGGGCAACGTTGTTCTTTA -> GGGCAACGTTGTTCTTTAT
GGGGCAGCCGACCGATAGA -> GGGCAGCCGACCGATAGAC
GGGGGCAGCCGACCGATAG -> GGGGCAGCCGACCGATAGA
GGGGTTGTTCGTTTGTATC -> GGGTTGTTCGTTTGTATCA
GGGTCAACCATGAAGTTAA -> GGTCAACCATGAAGTTAAC
GGGTCCGTTGACCGACAGT -> GGTCCGTTGACCGACAGTT
GGGTGCGATGATGGGTCAA -> GGTGCGATGATGGGTCAAC
GGGTGTTGTACCCGACGGA -> GGTGTTGTACCCGACGGAT
GGGTTACCGACCCGGTGAT -> GGTTACCGACCCGGTGATG
GGGTTACCGCAGTCGTAAA -> GGTTACCGCAGTCGTAAAC
GGGTTGTTCGTTTGTATCA -> GGTTGTTCGTTTGTATCAG
GGGTTTTAGGTTGTGAGTG -> GGTTTTAGGTTGTGAGTGA
GGTAAATAGAGCTACTACG -> GTAAATAGAGCTACTACGC
GGTAAGTCATAGAGCTCCA -> GTAAGTCATAGAGCTCCAA
GGTAATTGTGCAATGACCA -> GTAATTGTGCAATGACCAG
GGTAATTGTGCACCGTAGC -> GTAATTGTGCACCGTAGCA
GGTAATTGTGCAGGCTGTG -> GTAATTGTGCAGGCTGTGA
GGTAATTGTGCATACGACG -> GTAATTGTGCATACGACGA
GGTACCCGACCGGCGAACC -> GTACCCGACCGGCGAACCT
GGTAGGGAGGTGAGGGATT -> GTAGGGAGGTGAGGGATTC
GGTATTGCTGCCATGGCTG -> GTATTGCTGCCATGGCTGT
GGTCAACCATGAAGTTAAC -> GTCAACCATGAAGTTAACA
GGTCCGGGCCCTGCGGGCC -> GTCCGGGCCCTGCGGGCCA
GGTCCGTTGACCGACAGTT -> GTCCGTTGACCGACAGTTA
GGTCCTAGAAGCAAAATGA -> GTCCTAGAAGCAAAATGAG
GGTCCTGATTTCCGTCTCC -> GTCCTGATTTCCGTCTCCT
GGTCTACAGAAATGTATAA -> GTCTACAGAAATGTATAAA
GGTCTCTGGAGACGCTGGC -> GTCTCTGGAGACGCTGGCC
GGTGAAAGCCGCAACCATA -> GTGAAAGCCGCAACCATAG
GGTGACTCTCTGGAGGCAT -> GTGACTCTCTGGAGGCATG
GGTGAGGGATTCGTCTGGT -> GTGAGGGATTCGTCTGGTA
GGTGAGTAGGACGCCGATA -> GTGAGTAGGACGCCGATAT
GGTGATCGGTCCGGGCCCT -> GTGATCGGTCCGGGCCCTG
GGTGATGGCTATCGTAGTA -> GTGATGGCTATCGTAGTAA
GGTGCGATGATGGGTCAAC -> GTGCGATGATGGGTCAACC
GGTGCGCGACAATAGGGCC -> GTGCGCGACAATAGGGCCT
GGTGGCTGGCCTCTCTGCA -> GTGGCTGGCCTCTCTGCAG
GGTGGTTCCTGTGGGGGCA -> GTGGTTCCTGTGGGGGCAG
GGTGTTGTACCCGACGGAT -> GTGTTGTACCCGACGGATT
GGTTACCGACCCGGTGATG -> GTTACCGACCCGGTGATGG
GGTTACCGCAGTCGTAAAC -> GTTACCGCAGTCGTAAACC
GGTTCCTGTGGGGGCAGCC -> GTTCCTGTGGGGGCAGCCG
GGTTCGCCACACTTCCGAG -> GTTCGCCACACTTCCGAGT
GGTTGGACCGATGAGTGCA -> GTTGGACCGATGAGTGCAA
GGTTGGGATGGATTGGTGG -> GTTGGGATGGATTGGTGGC
GGTTGTGAGTGACGCACGT -> GTTGTGAGTGACGCACGTC
GGTTGTTCGTTTGTATCAG -> GTTGTTCGTTTGTATCAGG
GGTTTCAATCCTAGTGACA -> GTTTCAATCCTAGTGACAC
GGTTTCATGCCGCCTTTCT -> GTTTCATGCCGCCTTTCTT
GGTTTTAGGTTGTGAGTGA -> GTTTTAGGTTGTGAGTGAC
GTAAACCGCGCGGTTTCAA -> TAAACCGCGCGGTTTCAAT
GTAAAGGCTAGAACAACAA -> TAAAGGCTAGAACAACAAC
GTAAATAGAGCTACTACGC -> TAAATAGAGCTACTACGCT
GTAACACGGAAGGAATGCC -> TAACACGGAAGGAATGCCG
GTAACCTGAGTTCGGACCG -> TAACCTGAGTTCGGACCGC
GTAAGTCATAGAGCTCCAA -> TAAGTCATAGAGCTCCAAC
GTAAGTCGAATCGACTTAA -> TAAGTCGAATCGACTTAAT
GTAATTGAACATATTCATA -> TAATTGAACATATTCATAC
GTAATTGTGCAATGACCAG -> TAATTGTGCAATGACCAGA
GTAATTGTGCACCGTAGCA -> TAATTGTGCACCGTAGCAT
GTAATTGTGCAGGCTGTGA -> TAATTGTGCAGGCTGTGAC
GTAATTGTGCATACGACGA -> TAATTGTGCATACGACGAC
GTACAGCCTGTCTAGTGAC -> TACAGCCTGTCTAGTGACG
GTACCCGACCGGCGAACCT -> TACCCGACCGGCGAACCTT
GTACCCGACGGATTAGCCG -> TACCCGACGGATTAGCCGG
GTACCGACCCATAAAACTC -> TACCGACCCATAAAACTCC
GTACGAGAGATTTTATACT -> TACGAGAGATTTTATACTG
GTACGGTAATTGTGCAATG -> TACGGTAATTGTGCAATGA
GTACGGTAATTGTGCACCG -> TACGGTAATTGTGCACCGT
GTACGGTAATTGTGCAGGC -> TACGGTAATTGTGCAGGCT
GTACGGTAATTGTGCATAC -> TACGGTAATTGTGCATACG
GTACGTAAAGGCTAGAACA -> TACGTAAAGGCTAGAACAA
GTACTCTTGAAGAGTATTT -> TACTCTTGAAGAGTATTTC
GTAGCATGTAGCCGACCAA -> TAGCATGTAGCCGACCAAA
GTAGCCGACCAAAGCGTAT -> TAGCCGACCAAAGCGTATG
GTAGGACGCCGATATAACT -> TAGGACGCCGATATAACTA
GTAGGGAGGTGAGGGATTC -> TAGGGAGGTGAGGGATTCG
GTAGTAAGTCGAATCGACT -> TAGTAAGTCGAATCGACTT
GTATAAAGGTTCGCCACAC -> TATAAAGGTTCGCCACACT
GTATAACCTCTGGCCTTTA -> TATAACCTCTGGCCTTTAG
GTATACGCCCGGGACTGCT -> TATACGCCCGGGACTGCTG
GTATATCCCGGCAGCATTT -> TATATCCCGGCAGCATTTG
GTATATGATGGCTGTGGCC -> TATATGATGGCTGTGGCCG
GTATCAGGGGATTAAAATA -> TATCAGGGGATTAAAATAC
GTATCTTGTTTTGTGGAAG -> TATCTTGTTTTGTGGAAGA
GTATGTAATTGAACATATT -> TATGTAATTGAACATATTC
GTATGTCCACTCACAATCG -> TATGTCCACTCACAATCGC
GTATGTCTTCGCAGGGATG -> TATGTCTTCGCAGGGATGG
GTATGTGACATAATATAGC -> TATGTGACATAATATAGCC
GTATTGCTGCCATGGCTGT -> TATTGCTGCCATGGCTGTA
GTATTTCATAGCTACGATT -> TATTTCATAGCTACGATTT
GTCAACCATGAAGTTAACA -> TCAACCATGAAGTTAACAT
GTCAAGATGTCTGTCGCTC -> TCAAGATGTCTGTCGCTCC
GTCACCTGAATTCGGTGAC -> TCACCTGAATTCGGTGACT
GTCACTAGACTGCGTAACC -> TCACTAGACTGCGTAACCT
GTCACTGCCAGTATCTTGT -> TCACTGCCAGTATCTTGTT
GTCAGAGGTAGGGAGGTGA -> TCAGAGGTAGGGAGGTGAG
GTCATAGAGCTCCAACCCC -> TCATAGAGCTCCAACCCCC
GTCATATCTCTTGGATAGG -> TCATATCTCTTGGATAGGT
GTCATATTACATACAACGT -> TCATATTACATACAACGTG
GTCCACTCACAATCGCGCG -> TCCACTCACAATCGCGCGT
GTCCCCACCTATCGTCACT -> TCCCCACCTATCGTCACTG
GTCCGCAACGACTCTTATT -> TCCGCAACGACTCTTATTT
GTCCGGGCCCTGCGGGCCA -> TCCGGGCCCTGCGGGCCAG
GTCCGTTGACCGACAGTTA -> TCCGTTGACCGACAGTTAT
GTCCTACTCTCAAACTAAT -> TCCTACTCTCAAACTAATT
GTCCTAGAAGCAAAATGAG -> TCCTAGAAGCAAAATGAGA
GTCCTCGGGTTACCGCAGT -> TCCTCGGGTTACCGCAGTC
GTCCTGACCCCCTTACAAT -> TCCTGACCCCCTTACAATG
GTCCTGATTTCCGTCTCCT -> TCCTGATTTCCGTCTCCTG
GTCGAAGAGAAAAACCGCC -> TCGAAGAGAAAAACCGCCT
GTCGAATCGACTTAATGAG -> TCGAATCGACTTAATGAGG
GTCGATAACCGATATCTGT -> TCGATAACCGATATCTGTA
GTCGCTCCCATACAACTTC -> TCGCTCCCATACAACTTCA
GTCGGACAATGGGGTTGTT -> TCGGACAATGGGGTTGTTC
GTCGGATATGAGCGTCATA -> TCGGATATGAGCGTCATAT
GTCGGTTTCATGCCGCCTT -> TCGGTTTCATGCCGCCTTT
GTCGTAAACCGCGCGGTTT -> TCGTAAACCGCGCGGTTTC
GTCGTGGTACCCGACCGGC -> TCGTGGTACCCGACCGGCG
GTCTACAGAAATGTATAAA -> TCTACAGAAATGTATAAAG
GTCTAGTGACGTGTACTCT -> TCTAGTGACGTGTACTCTT
GTCTCCTGTATACGCCCGG -> TCTCCTGTATACGCCCGGG
GTCTCTGGAGACGCTGGCC -> TCTCTGGAGACGCTGGCCC
GTCTGGTATTGCTGCCATG -> TCTGGTATTGCTGCCATGG
GTCTGTCGCTCCCATACAA -> TCTGTCGCTCCCATACAAC
GTCTTCGCAGGGATGGGAT -> TCTTCGCAGGGATGGGATT
GTGAAAGCCGCAACCATAG -> TGAAAGCCGCAACCATAGT
GTGACACAAAACGACGAGA -> TGACACAAAACGACGAGAG
GTGACATAATATAGCCATC -> TGACATAATATAGCCATCT
GTGACGCACGTCAGAGGTA -> TGACGCACGTCAGAGGTAG
GTGACGGAGCCGACCAAAG -> TGACGGAGCCGACCAAAGC
GTGACGTCGAAGAGAAAAA -> TGACGTCGAAGAGAAAAAC
GTGACGTGTACTCTTGAAG -> TGACGTGTACTCTTGAAGA
GTGACTCTCTGGAGGCATG -> TGACTCTCTGGAGGCATGA
GTGAGGGATTCGTCTGGTA -> TGAGGGATTCGTCTGGTAT
GTGAGTAGGACGCCGATAT -> TGAGTAGGACGCCGATATA
GTGAGTGACGCACGTCAGA -> TGAGTGACGCACGTCAGAG
GTGATCGGTCCGGGCCCTG -> TGATCGGTCCGGGCCCTGC
GTGATGGCTATCGTAGTAA -> TGATGGCTATCGTAGTAAG
GTGATTGATACTTAGGCTG -> TGATTGATACTTAGGCTGT
GTGCAACAACAGACGTCAC -> TGCAACAACAGACGTCACT
GTGCAATGACCAGAGAAGC -> TGCAATGACCAGAGAAGCC
GTGCACCGTAGCATGTAGC -> TGCACCGTAGCATGTAGCC
GTGCAGGCTGTGACGGAGC -> TGCAGGCTGTGACGGAGCC
GTGCATACGACGACCTAGC -> TGCATACGACGACCTAGCC
GTGCATTGCGTTGTCACCT -> TGCATTGCGTTGTCACCTG
GTGCGATGATGGGTCAACC -> TGCGATGATGGGTCAACCA
GTGCGCGACAATAGGGCCT -> TGCGCGACAATAGGGCCTG
GTGCGTGTCCGCAACGACT -> TGCGTGTCCGCAACGACTC
GTGGAAGATGTATAACCTC -> TGGAAGATGTATAACCTCT
GTGGCAAAGGACATCCAAA -> TGGCAAAGGACATCCAAAT
GTGGCCGAACACAGGCGGA -> TGGCCGAACACAGGCGGAG
GTGGCTGGCCTCTCTGCAG -> TGGCTGGCCTCTCTGCAGT
GTGGGGCAACGTTGTTCTT -> TGGGGCAACGTTGTTCTTT
GTGGGGGCAGCCGACCGAT -> TGGGGGCAGCCGACCGATA
GTGGTACCCGACCGGCGAA -> TGGTACCCGACCGGCGAAC
GTGGTTCCTGTGGGGGCAG -> TGGTTCCTGTGGGGGCAGC
GTGTACGAGAGATTTTATA -> TGTACGAGAGATTTTATAC
GTGTACTCTTGAAGAGTAT -> TGTACTCTTGAAGAGTATT
GTGTCCGCAACGACTCTTA -> TGTCCGCAACGACTCTTAT
GTGTCGTGGTACCCGACCG -> TGTCGTGGTACCCGACCGG
GTGTTCACGCATTGATAAA -> TGTTCACGCATTGATAAAT
GTGTTGTACCCGACGGATT -> TGTTGTACCCGACGGATTA
GTGTTTATAATTCGTTACC -> TGTTTATAATTCGTTACCA
GTTAACATCTTGATCAATC -> TTAACATCTTGATCAATCG
GTTACCAAAAAAATAACAT -> TTACCAAAAAAATAACATC
GTTACCGACCCGGTGATGG -> TTACCGACCCGGTGATGGC
GTTACCGCAGTCGTAAACC -> TTACCGCAGTCGTAAACCG
GTTACTCGTGTACGAGAGA -> TTACTCGTGTACGAGAGAT
GTTATACCAGGTCCTAGAA -> TTATACCAGGTCCTAGAAG
GTTCAAAATGTACAGCCTG -> TTCAAAATGTACAGCCTGT
GTTCAAGTCCTGACCCCCT -> TTCAAGTCCTGACCCCCTT
GTTCACGCATTGATAAATC -> TTCACGCATTGATAAATCG
GTTCAGGCTAAACATAAAG -> TTCAGGCTAAACATAAAGC
GTTCATGGAAGAGGAAGGC -> TTCATGGAAGAGGAAGGCC
GTTCCCAATACGGTAAATA -> TTCCCAATACGGTAAATAG
GTTCCTGTGGGGGCAGCCG -> TTCCTGTGGGGGCAGCCGA
GTTCGCCACACTTCCGAGT -> TTCGCCACACTTCCGAGTT
GTTCGGACCGCTATATTTG -> TTCGGACCGCTATATTTGA
GTTCGTTTGTATCAGGGGA -> TTCGTTTGTATCAGGGGAT
GTTCTTTATTGGTAAGTCA -> TTCTTTATTGGTAAGTCAT
GTTGAACAAGTGACGTCGA -> TTGAACAAGTGACGTCGAA
GTTGACCGACAGTTATACC -> TTGACCGACAGTTATACCA
GTTGGACCGATGAGTGCAA -> TTGGACCGATGAGTGCAAC
GTTGGGATGGATTGGTGGC -> TTGGGATGGATTGGTGGCT
GTTGTACCCGACGGATTAG -> TTGTACCCGACGGATTAGC
GTTGTCACCTGAATTCGGT -> TTGTCACCTGAATTCGGTG
GTTGTCATATTACATACAA -> TTGTCATATTACATACAAC
GTTGTGAGTGACGCACGTC -> TTGTGAGTGACGCACGTCA
GTTGTTCGTTTGTATCAGG -> TTGTTCGTTTGTATCAGGG
GTTGTTCTTTATTGGTAAG -> TTGTTCTTTATTGGTAAGT
GTTTATAATTCGTTACCAA -> TTTATAATTCGTTACCAAA
GTTTCAATCCTAGTGACAC -> TTTCAATCCTAGTGACACA
GTTTCATCTAAGTGCATTG -> TTTCATCTAAGTGCATTGC
GTTTCATGCCGCCTTTCTT -> TTTCATGCCGCCTTTCTTA
GTTTGTATCAGGGGATTAA -> TTTGTATCAGGGGATTAAA
GTTTTAGGTTGTGAGTGAC -> TTTTAGGTTGTGAGTGACG
GTTTTCGAGATACAGGTCT -> TTTTCGAGATACAGGTCTC
GTTTTGTGGAAGATGTATA -> TTTTGTGGAAGATGTATAA
TAAAACGCTGCAACCAGGA -> AAAACGCTGCAACCAGGAT
TAAAACTCCTGTCCTCGGG -> AAAACTCCTGTCCTCGGGT
TAAAATACCGCCCAGAATT -> AAAATACCGCCCAGAATTT
TAAACATAAAGCTGGAACG -> AAACATAAAGCTGGAACGC
TAAACCGCGCGGTTTCAAT -> AAACCGCGCGGTTTCAATC
TAAACGGGTTACCGACCCG -> AAACGGGTTACCGACCCGG
TAAAGCTGGAACGCTACGG -> AAAGCTGGAACGCTACGGG
TAAAGGCTAGAACAACAAC -> AAAGGCTAGAACAACAACG
TAAAGGTTCGCCACACTTC -> AAAGGTTCGCCACACTTCC
TAAATAGAGCTACTACGCT -> AAATAGAGCTACTACGCTA
TAAATCGAGCACCTCGGTG -> AAATCGAGCACCTCGGTGA
TAACACGGAAGGAATGCCG -> AACACGGAAGGAATGCCGC
TAACATCAGTACCGACCCA -> AACATCAGTACCGACCCAT
TAACATCTTGATCAATCGA -> AACATCTTGATCAATCGAT
TAACCGATATCTGTACGGT -> AACCGATATCTGTACGGTA
TAACCTCTGGCCTTTAGAG -> AACCTCTGGCCTTTAGAGT
TAACCTGAGTTCGGACCGC -> AACCTGAGTTCGGACCGCT
TAACTATTCCAACCTTCCC -> AACTATTCCAACCTTCCCC
TAACTCGAATCCCCTTTCC -> AACTCGAATCCCCTTTCCT
TAAGCAGCATGTTTCATCT -> AAGCAGCATGTTTCATCTA
TAAGCTGAATGTCGATAAC -> AAGCTGAATGTCGATAACC
TAAGTCATAGAGCTCCAAC -> AAGTCATAGAGCTCCAACC
TAAGTCGAATCGACTTAAT -> AAGTCGAATCGACTTAATG
TAAGTGCATTGCGTTGTCA -> AAGTGCATTGCGTTGTCAC
TAAGTTCAAGTCCTGACCC -> AAGTTCAAGTCCTGACCCC
TAAGTTGTCATATTACATA -> AAGTTGTCATATTACATAC
TAATACAGCAGACCCCACA -> AATACAGCAGACCCCACAC
TAATATAGCCATCTAAGCT -> AATATAGCCATCTAAGCTG
TAATGAGGTTGGGATGGAT -> AATGAGGTTGGGATGGATT
TAATTCGTTACCAAAAAAA -> AATTCGTTACCAAAAAAAT
TAATTGAACATATTCATAC -> AATTGAACATATTCATACA
TAATTGGACCAGTTCATGG -> AATTGGACCAGTTCATGGA
TAATTGTGCAATGACCAGA -> AATTGTGCAATGACCAGAG
TAATTGTGCACCGTAGCAT -> AATTGTGCACCGTAGCATG
TAATTGTGCAGGCTGTGAC -> AATTGTGCAGGCTGTGACG
TAATTGTGCATACGACGAC -> AATTGTGCATACGACGACC
TACAACGTGTTCACGCATT -> ACAACGTGTTCACGCATTG
TACAACTTCACTCAGCTAT -> ACAACTTCACTCAGCTATA
TACAATGTCGGATATGAGC -> ACAATGTCGGATATGAGCG
TACACCGAGCTATTTTAAC -> ACACCGAGCTATTTTAACT
TACAGAAATGTATAAAGGT -> ACAGAAATGTATAAAGGTT
TACAGCAGACCCCACACGT -> ACAGCAGACCCCACACGTT
TACAGCCTGTCTAGTGACG -> ACAGCCTGTCTAGTGACGT
TACAGGTCTCTGGAGACGC -> ACAGGTCTCTGGAGACGCT
TACATACAACGTGTTCACG -> ACATACAACGTGTTCACGC
TACCAAAAAAATAACATCA -> ACCAAAAAAATAACATCAG
TACCAGGTCCTAGAAGCAA -> ACCAGGTCCTAGAAGCAAA
TACCCGACCGGCGAACCTT -> ACCCGACCGGCGAACCTTT
TACCCGACGGATTAGCCGG -> ACCCGACGGATTAGCCGGT
TACCGACCCATAAAACTCC -> ACCGACCCATAAAACTCCT
TACCGACCCGGTGATGGCT -> ACCGACCCGGTGATGGCTA
TACCGAGCCAATATTGAGG -> ACCGAGCCAATATTGAGGA
TACCGCAGTCGTAAACCGC -> ACCGCAGTCGTAAACCGCG
TACCGCCCAGAATTTCGAG -> ACCGCCCAGAATTTCGAGT
TACCGCTCATCGGTCCTGA -> ACCGCTCATCGGTCCTGAT
TACCTGGCTGGGCATGAAG -> ACCTGGCTGGGCATGAAGC
TACGACGACCTAGCCGACC -> ACGACGACCTAGCCGACCA
TACGAGAGATTTTATACTG -> ACGAGAGATTTTATACTGG
TACGATGGTCTACAGAAAT -> ACGATGGTCTACAGAAATG
TACGATTTGAACCCCGACT -> ACGATTTGAACCCCGACTG
TACGCCCGGGACTGCTGAC -> ACGCCCGGGACTGCTGACG
TACGCTAAAACGCTGCAAC -> ACGCTAAAACGCTGCAACC
TACGGGTGTTGTACCCGAC -> ACGGGTGTTGTACCCGACG
TACGGTAAATAGAGCTACT -> ACGGTAAATAGAGCTACTA
TACGGTAATTGTGCAATGA -> ACGGTAATTGTGCAATGAC
TACGGTAATTGTGCACCGT -> ACGGTAATTGTGCACCGTA
TACGGTAATTGTGCAGGCT -> ACGGTAATTGTGCAGGCTG
TACGGTAATTGTGCATACG -> ACGGTAATTGTGCATACGA
TACGTAAAGGCTAGAACAA -> ACGTAAAGGCTAGAACAAC
TACTACGCTAAAACGCTGC -> ACTACGCTAAAACGCTGCA
TACTCGTGTACGAGAGATT -> ACTCGTGTACGAGAGATTT
TACTCTCAAACTAATTGGA -> ACTCTCAAACTAATTGGAC
TACTCTTGAAGAGTATTTC -> ACTCTTGAAGAGTATTTCA
TACTGGTGGTTCCTGTGGG -> ACTGGTGGTTCCTGTGGGG
TACTTAGGCTGTACGGTAA -> ACTTAGGCTGTACGGTAAT
TAGAACAACAACGCCCTGC -> AGAACAACAACGCCCTGCG
TAGAAGCAAAATGAGACCA -> AGAAGCAAAATGAGACCAG
TAGACAAGATAAGTTCAAG -> AGACAAGATAAGTTCAAGT
TAGACTGCGTAACCTGAGT -> AGACTGCGTAACCTGAGTT
TAGAGCACGCGCGACCCTA -> AGAGCACGCGCGACCCTAT
TAGAGCCTCTCATAGTACG -> AGAGCCTCTCATAGTACGT
TAGAGCTACTACGCTAAAA -> AGAGCTACTACGCTAAAAC
TAGAGCTCCAACCCCCATA -> AGAGCTCCAACCCCCATAG
TAGAGTCCTACTCTCAAAC -> AGAGTCCTACTCTCAAACT
TAGCATGTAGCCGACCAAA -> AGCATGTAGCCGACCAAAG
TAGCCATCTAAGCTGAATG -> AGCCATCTAAGCTGAATGT
TAGCCGACCAAAGCGTATG -> AGCCGACCAAAGCGTATGT,AGCCGACCAAAGCGTATGT
TAGCCGGTGAGTAGGACGC -> AGCCGGTGAGTAGGACGCC
TAGCTACGATTTGAACCCC -> AGCTACGATTTGAACCCCG
TAGGACGCCGATATAACTA -> AGGACGCCGATATAACTAT
TAGGCTGTACGGTAATTGT -> AGGCTGTACGGTAATTGTG
TAGGGAGGTGAGGGATTCG -> AGGGAGGTGAGGGATTCGT
TAGGGCCTGGGAGTGCGTG -> AGGGCCTGGGAGTGCGTGT
TAGGTGAAAGCCGCAACCA -> AGGTGAAAGCCGCAACCAT
TAGGTTGTGAGTGACGCAC -> AGGTTGTGAGTGACGCACG
TAGTAAGTCGAATCGACTT -> AGTAAGTCGAATCGACTTA
TAGTACGTAAAGGCTAGAA -> AGTACGTAAAGGCTAGAAC
TAGTATATCCCGGCAGCAT -> AGTATATCCCGGCAGCATT
TAGTGACACAAAACGACGA -> AGTGACACAAAACGACGAG
TAGTGACGTGTACTCTTGA -> AGTGACGTGTACTCTTGAA
TAGTGTCGTGGTACCCGAC -> AGTGTCGTGGTACCCGACC
TATAAAGGTTCGCCACACT -> ATAAAGGTTCGCCACACTT
TATAACCTCTGGCCTTTAG -> ATAACCTCTGGCCTTTAGA
TATAACTATTCCAACCTTC -> ATAACTATTCCAACCTTCC
TATAATTCGTTACCAAAAA -> ATAATTCGTTACCAAAAAA
TATACCAGGTCCTAGAAGC -> ATACCAGGTCCTAGAAGCA
TATACGCCCGGGACTGCTG -> ATACGCCCGGGACTGCTGA
TATACTGGTGGTTCCTGTG -> ATACTGGTGGTTCCTGTGG
TATAGCCATCTAAGCTGAA -> ATAGCCATCTAAGCTGAAT
TATATCCCGGCAGCATTTG -> ATATCCCGGCAGCATTTGT
TATATGATGGCTGTGGCCG -> ATATGATGGCTGTGGCCGA
TATATTTGACCGCGCAGCA -> ATATTTGACCGCGCAGCAG
TATCAGGGGATTAAAATAC -> ATCAGGGGATTAAAATACC
TATCCCGGCAGCATTTGTT -> ATCCCGGCAGCATTTGTTC
TATCGTAGTAAGTCGAATC -> ATCGTAGTAAGTCGAATCG
TATCGTCACTGCCAGTATC -> ATCGTCACTGCCAGTATCT
TATCTCTTGGATAGGTGAA -> ATCTCTTGGATAGGTGAAA
TATCTGTACGGTAATTGTG -> ATCTGTACGGTAATTGTGC
TATCTTGTTTTGTGGAAGA -> ATCTTGTTTTGTGGAAGAT
TATGAGCGTCATATCTCTT -> ATGAGCGTCATATCTCTTG
TATGATGGCTGTGGCCGAA -> ATGATGGCTGTGGCCGAAC
TATGTAATTGAACATATTC -> ATGTAATTGAACATATTCA
TATGTCCACTCACAATCGC -> ATGTCCACTCACAATCGCG
TATGTCTTCGCAGGGATGG -> ATGTCTTCGCAGGGATGGG
TATGTGACATAATATAGCC -> ATGTGACATAATATAGCCA
TATTACATACAACGTGTTC -> ATTACATACAACGTGTTCA
TATTAGTATATCCCGGCAG -> ATTAGTATATCCCGGCAGC
TATTCATACACCGAGCTAT -> ATTCATACACCGAGCTATT
TATTCCAACCTTCCCCGTT -> ATTCCAACCTTCCCCGTTC
TATTGAGGATGCACCATGT -> ATTGAGGATGCACCATGTG
TATTGCTGCCATGGCTGTA -> ATTGCTGCCATGGCTGTAA
TATTGGTAAGTCATAGAGC -> ATTGGTAAGTCATAGAGCT
TATTTCATAGCTACGATTT -> ATTTCATAGCTACGATTTG
TATTTGAAGACAGGGATAA -> ATTTGAAGACAGGGATAAG
TATTTGACCGCGCAGCAGG -> ATTTGACCGCGCAGCAGGA
TATTTGGACGGCTGTCCCC -> ATTTGGACGGCTGTCCCCA
TATTTTAACTCGAATCCCC -> ATTTTAACTCGAATCCCCT
TCAAAATGTACAGCCTGTC -> CAAAATGTACAGCCTGTCT
TCAAACTAATTGGACCAGT -> CAAACTAATTGGACCAGTT
TCAACCATGAAGTTAACAT -> CAACCATGAAGTTAACATC
TCAACCCGGGCAGTTCAGG -> CAACCCGGGCAGTTCAGGC
TCAAGATGTCTGTCGCTCC -> CAAGATGTCTGTCGCTCCC
TCAAGTCCTGACCCCCTTA -> CAAGTCCTGACCCCCTTAC
TCAATCCTAGTGACACAAA -> CAATCCTAGTGACACAAAA
TCAATCGATACGATGGTCT -> CAATCGATACGATGGTCTA
TCACAATCGCGCGTATATG -> CACAATCGCGCGTATATGA
TCACCTGAATTCGGTGACT -> CACCTGAATTCGGTGACTC
TCACGCATTGATAAATCGA -> CACGCATTGATAAATCGAG
TCACTAGACTGCGTAACCT -> CACTAGACTGCGTAACCTG
TCACTCAGCTATAAGAGTC -> CACTCAGCTATAAGAGTCT
TCACTGCCAGTATCTTGTT -> CACTGCCAGTATCTTGTTT
TCAGAGGTAGGGAGGTGAG -> CAGAGGTAGGGAGGTGAGG
TCAGGCTAAACATAAAGCT -> CAGGCTAAACATAAAGCTG
TCAGGGGATTAAAATACCG -> CAGGGGATTAAAATACCGC
TCAGTACCGACCCATAAAA -> CAGTACCGACCCATAAAAC
TCATACACCGAGCTATTTT -> CATACACCGAGCTATTTTA
TCATAGAGCTCCAACCCCC -> CATAGAGCTCCAACCCCCA
TCATAGCTACGATTTGAAC -> CATAGCTACGATTTGAACC
TCATAGTACGTAAAGGCTA -> CATAGTACGTAAAGGCTAG
TCATATCTCTTGGATAGGT -> CATATCTCTTGGATAGGTG
TCATATTACATACAACGTG -> CATATTACATACAACGTGT
TCATCGGTCCTGATTTCCG -> CATCGGTCCTGATTTCCGT
TCATCTAAGTGCATTGCGT -> CATCTAAGTGCATTGCGTT
TCATGCCGCCTTTCTTACC -> CATGCCGCCTTTCTTACCT
TCATGGAAGAGGAAGGCCA -> CATGGAAGAGGAAGGCCAA
TCCAAATACCGAGCCAATA -> CCAAATACCGAGCCAATAT
TCCAACCCCCATAGAGCAC -> CCAACCCCCATAGAGCACG
TCCAACCTTCCCCGTTCCC -> CCAACCTTCCCCGTTCCCA
TCCACAGTGATTGATACTT -> CCACAGTGATTGATACTTA
TCCACTCACAATCGCGCGT -> CCACTCACAATCGCGCGTA
TCCCAATACGGTAAATAGA -> CCCAATACGGTAAATAGAG
TCCCATACAACTTCACTCA -> CCCATACAACTTCACTCAG
TCCCCACCTATCGTCACTG -> CCCCACCTATCGTCACTGC
TCCCCGTTCCCAATACGGT -> CCCCGTTCCCAATACGGTA
TCCCCTTTCCTATTTGGAC -> CCCCTTTCCTATTTGGACG
TCCCGGCAGCATTTGTTCA -> CCCGGCAGCATTTGTTCAA
TCCGAGTTTTCGAGATACA -> CCGAGTTTTCGAGATACAG
TCCGCAACGACTCTTATTT -> CCGCAACGACTCTTATTTG
TCCGGAGGGTCCGTTGACC -> CCGGAGGGTCCGTTGACCG
TCCGGGCCCTGCGGGCCAG -> CCGGGCCCTGCGGGCCAGT
TCCGTCTCCTGTATACGCC -> CCGTCTCCTGTATACGCCC
TCCGTTGACCGACAGTTAT -> CCGTTGACCGACAGTTATA
TCCTACTCTCAAACTAATT -> CCTACTCTCAAACTAATTG
TCCTAGAAGCAAAATGAGA -> CCTAGAAGCAAAATGAGAC
TCCTAGTGACACAAAACGA -> CCTAGTGACACAAAACGAC
TCCTATTTGGACGGCTGTC -> CCTATTTGGACGGCTGTCC
TCCTCGGGTTACCGCAGTC -> CCTCGGGTTACCGCAGTCG
TCCTGACCCCCTTACAATG -> CCTGACCCCCTTACAATGT
TCCTGATTTCCGTCTCCTG -> CCTGATTTCCGTCTCCTGT
TCCTGTATACGCCCGGGAC -> CCTGTATACGCCCGGGACT
TCCTGTCCTCGGGTTACCG -> CCTGTCCTCGGGTTACCGC
TCCTGTGGGGGCAGCCGAC -> CCTGTGGGGGCAGCCGACC
TCGAAGAGAAAAACCGCCT -> CGAAGAGAAAAACCGCCTC
TCGAATCCCCTTTCCTATT -> CGAATCCCCTTTCCTATTT
TCGAATCGACTTAATGAGG -> CGAATCGACTTAATGAGGT
TCGACTTAATGAGGTTGGG -> CGACTTAATGAGGTTGGGA
TCGAGATACAGGTCTCTGG -> CGAGATACAGGTCTCTGGA
TCGAGCACCTCGGTGATCG -> CGAGCACCTCGGTGATCGG
TCGAGTGGCAAAGGACATC -> CGAGTGGCAAAGGACATCC
TCGATAACCGATATCTGTA -> CGATAACCGATATCTGTAC
TCGATACGATGGTCTACAG -> CGATACGATGGTCTACAGA
TCGCAGGGATGGGATTTAA -> CGCAGGGATGGGATTTAAA
TCGCCACACTTCCGAGTTT -> CGCCACACTTCCGAGTTTT
TCGCCCCGAGTTGAACAAG -> CGCCCCGAGTTGAACAAGT
TCGCGCGTATATGATGGCT -> CGCGCGTATATGATGGCTG
TCGCTCCCATACAACTTCA -> CGCTCCCATACAACTTCAC
TCGGACAATGGGGTTGTTC -> CGGACAATGGGGTTGTTCG
TCGGACCGCTATATTTGAC -> CGGACCGCTATATTTGACC
TCGGATATGAGCGTCATAT -> CGGATATGAGCGTCATATC
TCGGGTTACCGCAGTCGTA -> CGGGTTACCGCAGTCGTAA
TCGGTCCGGGCCCTGCGGG -> CGGTCCGGGCCCTGCGGGC
TCGGTCCTGATTTCCGTCT -> CGGTCCTGATTTCCGTCTC
TCGGTGACTCTCTGGAGGC -> CGGTGACTCTCTGGAGGCA
TCGGTGATCGGTCCGGGCC -> CGGTGATCGGTCCGGGCCC
TCGGTTGGACCGATGAGTG -> CGGTTGGACCGATGAGTGC
TCGGTTTCATGCCGCCTTT -> CGGTTTCATGCCGCCTTTC
TCGTAAACCGCGCGGTTTC -> CGTAAACCGCGCGGTTTCA
TCGTAGTAAGTCGAATCGA -> CGTAGTAAGTCGAATCGAC
TCGTCACTGCCAGTATCTT -> CGTCACTGCCAGTATCTTG
TCGTCTGGTATTGCTGCCA -> CGTCTGGTATTGCTGCCAT
TCGTGGTACCCGACCGGCG -> CGTGGTACCCGACCGGCGA
TCGTGTACGAGAGATTTTA -> CGTGTACGAGAGATTTTAT
TCGTTACCAAAAAAATAAC -> CGTTACCAAAAAAATAACA
TCGTTTGTATCAGGGGATT -> CGTTTGTATCAGGGGATTA
TCTAAGCTGAATGTCGATA -> CTAAGCTGAATGTCGATAA
TCTAAGTGCATTGCGTTGT -> CTAAGTGCATTGCGTTGTC
TCTACAGAAATGTATAAAG -> CTACAGAAATGTATAAAGG
TCTAGTGACGTGTACTCTT -> CTAGTGACGTGTACTCTTG
TCTCAAACTAATTGGACCA -> CTCAAACTAATTGGACCAG
TCTCATAGTACGTAAAGGC -> CTCATAGTACGTAAAGGCT
TCTCCTGTATACGCCCGGG -> CTCCTGTATACGCCCGGGA
TCTCTGCAGTCGGACAATG -> CTCTGCAGTCGGACAATGG
TCTCTGGAGACGCTGGCCC -> CTCTGGAGACGCTGGCCCT
TCTCTGGAGGCATGAAGCT -> CTCTGGAGGCATGAAGCTC
TCTCTTGGATAGGTGAAAG -> CTCTTGGATAGGTGAAAGC
TCTGCAGTCGGACAATGGG -> CTGCAGTCGGACAATGGGG
TCTGGAGACGCTGGCCCTG -> CTGGAGACGCTGGCCCTGT
TCTGGAGGCATGAAGCTCC -> CTGGAGGCATGAAGCTCCG
TCTGGCCTTTAGAGTCCTA -> CTGGCCTTTAGAGTCCTAC
TCTGGTATTGCTGCCATGG -> CTGGTATTGCTGCCATGGC
TCTGTACGGTAATTGTGCA -> CTGTACGGTAATTGTGCAT
TCTGTCGCTCCCATACAAC -> CTGTCGCTCCCATACAACT
TCTTACCTGGCTGGGCATG -> CTTACCTGGCTGGGCATGA
TCTTATTTGAAGACAGGGA -> CTTATTTGAAGACAGGGAT
TCTTCGCAGGGATGGGATT -> CTTCGCAGGGATGGGATTT
TCTTGAAGAGTATTTCATA -> CTTGAAGAGTATTTCATAG
TCTTGATCAATCGATACGA -> CTTGATCAATCGATACGAT
TCTTGGATAGGTGAAAGCC -> CTTGGATAGGTGAAAGCCG
TCTTGTTTTGTGGAAGATG -> CTTGTTTTGTGGAAGATGT
TCTTTATTGGTAAGTCATA -> CTTTATTGGTAAGTCATAG
TGAAAGCCGCAACCATAGT -> GAAAGCCGCAACCATAGTG
TGAACAAGTGACGTCGAAG -> GAACAAGTGACGTCGAAGA
TGAACATATTCATACACCG -> GAACATATTCATACACCGA
TGAACCCCGACTGAAGGGA -> GAACCCCGACTGAAGGGAT
TGAAGACAGGGATAAGCAG -> GAAGACAGGGATAAGCAGC
TGAAGAGTATTTCATAGCT -> GAAGAGTATTTCATAGCTA
TGAAGCCCAACGGGTGCGA -> GAAGCCCAACGGGTGCGAT
TGAAGCTCCGGAGGGTCCG -> GAAGCTCCGGAGGGTCCGT
TGAAGGGATGAGGCACTGT -> GAAGGGATGAGGCACTGTA
TGAAGTTAACATCTTGATC -> GAAGTTAACATCTTGATCA
TGAATGTCGATAACCGATA -> GAATGTCGATAACCGATAT
TGAATTCGGTGACTCTCTG -> GAATTCGGTGACTCTCTGG
TGACACAAAACGACGAGAG -> GACACAAAACGACGAGAGC
TGACATAATATAGCCATCT -> GACATAATATAGCCATCTA
TGACCAGAGAAGCCGACCA -> GACCAGAGAAGCCGACCAA
TGACCCCCTTACAATGTCG -> GACCCCCTTACAATGTCGG
TGACCGACAGTTATACCAG -> GACCGACAGTTATACCAGG
TGACCGCGCAGCAGGAGCT -> GACCGCGCAGCAGGAGCTG
TGACGCACGTCAGAGGTAG -> GACGCACGTCAGAGGTAGG
TGACGCCGTGTTTATAATT -> GACGCCGTGTTTATAATTC
TGACGGAGCCGACCAAAGC -> GACGGAGCCGACCAAAGCG
TGACGTCGAAGAGAAAAAC -> GACGTCGAAGAGAAAAACC
TGACGTGTACTCTTGAAGA -> GACGTGTACTCTTGAAGAG
TGACTCTCTGGAGGCATGA -> GACTCTCTGGAGGCATGAA
TGACTTTGAGCACATACCG -> GACTTTGAGCACATACCGC
TGAGACCAGGGCTAATACA -> GAGACCAGGGCTAATACAG
TGAGCACATACCGCTCATC -> GAGCACATACCGCTCATCG
TGAGCGTCATATCTCTTGG -> GAGCGTCATATCTCTTGGA
TGAGGATGCACCATGTGGG -> GAGGATGCACCATGTGGGG
TGAGGCACTGTACGGTAAT -> GAGGCACTGTACGGTAATT
TGAGGGATTCGTCTGGTAT -> GAGGGATTCGTCTGGTATT
TGAGGTTGGGATGGATTGG -> GAGGTTGGGATGGATTGGT
TGAGTAGGACGCCGATATA -> GAGTAGGACGCCGATATAA
TGAGTGACGCACGTCAGAG -> GAGTGACGCACGTCAGAGG
TGAGTGCAACAACAGACGT -> GAGTGCAACAACAGACGTC
TGAGTTCGGACCGCTATAT -> GAGTTCGGACCGCTATATT
TGATAAATCGAGCACCTCG -> GATAAATCGAGCACCTCGG
TGATAAGTTGTCATATTAC -> GATAAGTTGTCATATTACA
TGATACTTAGGCTGTACGG -> GATACTTAGGCTGTACGGT
TGATCAATCGATACGATGG -> GATCAATCGATACGATGGT
TGATCGGTCCGGGCCCTGC -> GATCGGTCCGGGCCCTGCG
TGATGGCTATCGTAGTAAG -> GATGGCTATCGTAGTAAGT
TGATGGCTGTGGCCGAACA -> GATGGCTGTGGCCGAACAC
TGATGGGTCAACCATGAAG -> GATGGGTCAACCATGAAGT
TGATTGATACTTAGGCTGT -> GATTGATACTTAGGCTGTA
TGATTTCCGTCTCCTGTAT -> GATTTCCGTCTCCTGTATA
TGCAACAACAGACGTCACT -> GCAACAACAGACGTCACTA
TGCAACCAGGATGGCTCGG -> GCAACCAGGATGGCTCGGT
TGCAATGACCAGAGAAGCC -> GCAATGACCAGAGAAGCCG
TGCACCATGTGGGGCAACG -> GCACCATGTGGGGCAACGT
TGCACCGTAGCATGTAGCC -> GCACCGTAGCATGTAGCCG
TGCAGGCTGTGACGGAGCC -> GCAGGCTGTGACGGAGCCG
TGCAGTCGGACAATGGGGT -> GCAGTCGGACAATGGGGTT
TGCATACGACGACCTAGCC -> GCATACGACGACCTAGCCG
TGCATTGCGTTGTCACCTG -> GCATTGCGTTGTCACCTGA
TGCCAGTATCTTGTTTTGT -> GCCAGTATCTTGTTTTGTG
TGCCATGGCTGTAACACGG -> GCCATGGCTGTAACACGGA
TGCCGCACAACCTCGCCCC -> GCCGCACAACCTCGCCCCG
TGCCGCCTTTCTTACCTGG -> GCCGCCTTTCTTACCTGGC
TGCGATGATGGGTCAACCA -> GCGATGATGGGTCAACCAT
TGCGCGACAATAGGGCCTG -> GCGCGACAATAGGGCCTGG
TGCGGAGGTGCGCGACAAT -> GCGGAGGTGCGCGACAATA
TGCGGGCCAGTCAAGATGT -> GCGGGCCAGTCAAGATGTC
TGCGTAACCTGAGTTCGGA -> GCGTAACCTGAGTTCGGAC
TGCGTGTCCGCAACGACTC -> GCGTGTCCGCAACGACTCT
TGCGTTGTCACCTGAATTC -> GCGTTGTCACCTGAATTCG
TGCTGACGCCGTGTTTATA -> GCTGACGCCGTGTTTATAA
TGCTGCCATGGCTGTAACA -> GCTGCCATGGCTGTAACAC
TGGAACGCTACGGGTGTTG -> GGAACGCTACGGGTGTTGT
TGGAAGAGGAAGGCCAAAC -> GGAAGAGGAAGGCCAAACT
TGGAAGATGTATAACCTCT -> GGAAGATGTATAACCTCTG
TGGACCAGTTCATGGAAGA -> GGACCAGTTCATGGAAGAG
TGGACCGATGAGTGCAACA -> GGACCGATGAGTGCAACAA
TGGACGGCTGTCCCCACCT -> GGACGGCTGTCCCCACCTA
TGGAGACGCTGGCCCTGTA -> GGAGACGCTGGCCCTGTAC
TGGAGGCATGAAGCTCCGG -> GGAGGCATGAAGCTCCGGA
TGGATAGGTGAAAGCCGCA -> GGATAGGTGAAAGCCGCAA
TGGATTGGTGGCTGGCCTC -> GGATTGGTGGCTGGCCTCT
TGGCAAAGGACATCCAAAT -> GGCAAAGGACATCCAAATA
TGGCCCTGTACGGTAATTG -> GGCCCTGTACGGTAATTGT
TGGCCGAACACAGGCGGAG -> GGCCGAACACAGGCGGAGC
TGGCCTCTCTGCAGTCGGA -> GGCCTCTCTGCAGTCGGAC
TGGCCTTTAGAGTCCTACT -> GGCCTTTAGAGTCCTACTC
TGGCTATCGTAGTAAGTCG -> GGCTATCGTAGTAAGTCGA
TGGCTCGGTTGGACCGATG -> GGCTCGGTTGGACCGATGA
TGGCTGGCCTCTCTGCAGT -> GGCTGGCCTCTCTGCAGTC
TGGCTGGGCATGAAGCCCA -> GGCTGGGCATGAAGCCCAA
TGGCTGTAACACGGAAGGA -> GGCTGTAACACGGAAGGAA
TGGCTGTGGCCGAACACAG -> GGCTGTGGCCGAACACAGG
TGGGAGTGCGTGTCCGCAA -> GGGAGTGCGTGTCCGCAAC
TGGGATGGATTGGTGGCTG -> GGGATGGATTGGTGGCTGG
TGGGATTTAAACGGGTTAC -> GGGATTTAAACGGGTTACC
TGGGCATGAAGCCCAACGG -> GGGCATGAAGCCCAACGGG
TGGGGCAACGTTGTTCTTT -> GGGGCAACGTTGTTCTTTA
TGGGGGCAGCCGACCGATA -> GGGGGCAGCCGACCGATAG
TGGGGTTGTTCGTTTGTAT -> GGGGTTGTTCGTTTGTATC
TGGGTCAACCATGAAGTTA -> GGGTCAACCATGAAGTTAA
TGGGTTTTAGGTTGTGAGT -> GGGTTTTAGGTTGTGAGTG
TGGTAAGTCATAGAGCTCC -> GGTAAGTCATAGAGCTCCA
TGGTACCCGACCGGCGAAC -> GGTACCCGACCGGCGAACC
TGGTATTGCTGCCATGGCT -> GGTATTGCTGCCATGGCTG
TGGTCTACAGAAATGTATA -> GGTCTACAGAAATGTATAA
TGGTGGCTGGCCTCTCTGC -> GGTGGCTGGCCTCTCTGCA
TGGTGGTTCCTGTGGGGGC -> GGTGGTTCCTGTGGGGGCA
TGGTTCCTGTGGGGGCAGC -> GGTTCCTGTGGGGGCAGCC
TGTAACACGGAAGGAATGC -> GTAACACGGAAGGAATGCC
TGTAATTGAACATATTCAT -> GTAATTGAACATATTCATA
TGTACAGCCTGTCTAGTGA -> GTACAGCCTGTCTAGTGAC
TGTACCCGACGGATTAGCC -> GTACCCGACGGATTAGCCG
TGTACGAGAGATTTTATAC -> GTACGAGAGATTTTATACT
TGTACGGTAATTGTGCAAT -> GTACGGTAATTGTGCAATG
TGTACGGTAATTGTGCACC -> GTACGGTAATTGTGCACCG
TGTACGGTAATTGTGCAGG -> GTACGGTAATTGTGCAGGC
TGTACGGTAATTGTGCATA -> GTACGGTAATTGTGCATAC
TGTACTCTTGAAGAGTATT -> GTACTCTTGAAGAGTATTT
TGTAGCCGACCAAAGCGTA -> GTAGCCGACCAAAGCGTAT
TGTATAAAGGTTCGCCACA -> GTATAAAGGTTCGCCACAC
TGTATAACCTCTGGCCTTT -> GTATAACCTCTGGCCTTTA
TGTATACGCCCGGGACTGC -> GTATACGCCCGGGACTGCT
TGTATCAGGGGATTAAAAT -> GTATCAGGGGATTAAAATA
TGTCACCTGAATTCGGTGA -> GTCACCTGAATTCGGTGAC
TGTCATATTACATACAACG -> GTCATATTACATACAACGT
TGTCCACTCACAATCGCGC -> GTCCACTCACAATCGCGCG
TGTCCCCACCTATCGTCAC -> GTCCCCACCTATCGTCACT
TGTCCGCAACGACTCTTAT -> GTCCGCAACGACTCTTATT
TGTCCTCGGGTTACCGCAG -> GTCCTCGGGTTACCGCAGT
TGTCGATAACCGATATCTG -> GTCGATAACCGATATCTGT
TGTCGCTCCCATACAACTT -> GTCGCTCCCATACAACTTC
TGTCGGATATGAGCGTCAT -> GTCGGATATGAGCGTCATA
TGTCGGTTTCATGCCGCCT -> GTCGGTTTCATGCCGCCTT
TGTCGTGGTACCCGACCGG -> GTCGTGGTACCCGACCGGC
TGTCTAGTGACGTGTACTC -> GTCTAGTGACGTGTACTCT
TGTCTGTCGCTCCCATACA -> GTCTGTCGCTCCCATACAA
TGTCTTCGCAGGGATGGGA -> GTCTTCGCAGGGATGGGAT
TGTGACATAATATAGCCAT -> GTGACATAATATAGCCATC
TGTGACGGAGCCGACCAAA -> GTGACGGAGCCGACCAAAG
TGTGAGTGACGCACGTCAG -> GTGAGTGACGCACGTCAGA
TGTGCAATGACCAGAGAAG -> GTGCAATGACCAGAGAAGC
TGTGCACCGTAGCATGTAG -> GTGCACCGTAGCATGTAGC
TGTGCAGGCTGTGACGGAG -> GTGCAGGCTGTGACGGAGC
TGTGCATACGACGACCTAG -> GTGCATACGACGACCTAGC
TGTGGAAGATGTATAACCT -> GTGGAAGATGTATAACCTC
TGTGGCCGAACACAGGCGG -> GTGGCCGAACACAGGCGGA
TGTGGGGCAACGTTGTTCT -> GTGGGGCAACGTTGTTCTT
TGTGGGGGCAGCCGACCGA -> GTGGGGGCAGCCGACCGAT
TGTTCAAAATGTACAGCCT -> GTTCAAAATGTACAGCCTG
TGTTCACGCATTGATAAAT -> GTTCACGCATTGATAAATC
TGTTCGTTTGTATCAGGGG -> GTTCGTTTGTATCAGGGGA
TGTTCTTTATTGGTAAGTC -> GTTCTTTATTGGTAAGTCA
TGTTGTACCCGACGGATTA -> GTTGTACCCGACGGATTAG
TGTTTATAATTCGTTACCA -> GTTTATAATTCGTTACCAA
TGTTTCATCTAAGTGCATT -> GTTTCATCTAAGTGCATTG
TGTTTTGTGGAAGATGTAT -> GTTTTGTGGAAGATGTATA
TTAAAATACCGCCCAGAAT -> TAAAATACCGCCCAGAATT
TTAAACGGGTTACCGACCC -> TAAACGGGTTACCGACCCG
TTAACATCTTGATCAATCG -> TAACATCTTGATCAATCGA
TTAACTCGAATCCCCTTTC -> TAACTCGAATCCCCTTTCC
TTAATGAGGTTGGGATGGA -> TAATGAGGTTGGGATGGAT
TTACAATGTCGGATATGAG -> TACAATGTCGGATATGAGC
TTACATACAACGTGTTCAC -> TACATACAACGTGTTCACG
TTACCAAAAAAATAACATC -> TACCAAAAAAATAACATCA
TTACCGACCCGGTGATGGC -> TACCGACCCGGTGATGGCT
TTACCGCAGTCGTAAACCG -> TACCGCAGTCGTAAACCGC
TTACCTGGCTGGGCATGAA -> TACCTGGCTGGGCATGAAG
TTACTCGTGTACGAGAGAT -> TACTCGTGTACGAGAGATT
TTAGAGTCCTACTCTCAAA -> TAGAGTCCTACTCTCAAAC
TTAGCCGGTGAGTAGGACG -> TAGCCGGTGAGTAGGACGC
TTAGGCTGTACGGTAATTG -> TAGGCTGTACGGTAATTGT
TTAGGTTGTGAGTGACGCA -> TAGGTTGTGAGTGACGCAC
TTAGTATATCCCGGCAGCA -> TAGTATATCCCGGCAGCAT
TTATAATTCGTTACCAAAA -> TATAATTCGTTACCAAAAA
TTATACCAGGTCCTAGAAG -> TATACCAGGTCCTAGAAGC
TTATACTGGTGGTTCCTGT -> TATACTGGTGGTTCCTGTG
TTATTGGTAAGTCATAGAG -> TATTGGTAAGTCATAGAGC
TTATTTGAAGACAGGGATA -> TATTTGAAGACAGGGATAA
TTCAAAATGTACAGCCTGT -> TCAAAATGTACAGCCTGTC
TTCAAGTCCTGACCCCCTT -> TCAAGTCCTGACCCCCTTA
TTCAATCCTAGTGACACAA -> TCAATCCTAGTGACACAAA
TTCACGCATTGATAAATCG -> TCACGCATTGATAAATCGA
TTCACTCAGCTATAAGAGT -> TCACTCAGCTATAAGAGTC
TTCAGGCTAAACATAAAGC -> TCAGGCTAAACATAAAGCT
TTCATACACCGAGCTATTT -> TCATACACCGAGCTATTTT
TTCATAGCTACGATTTGAA -> TCATAGCTACGATTTGAAC
TTCATCTAAGTGCATTGCG -> TCATCTAAGTGCATTGCGT
TTCATGCCGCCTTTCTTAC -> TCATGCCGCCTTTCTTACC
TTCATGGAAGAGGAAGGCC -> TCATGGAAGAGGAAGGCCA
TTCCAACCTTCCCCGTTCC -> TCCAACCTTCCCCGTTCCC
TTCCCAATACGGTAAATAG -> TCCCAATACGGTAAATAGA
TTCCCCGTTCCCAATACGG -> TCCCCGTTCCCAATACGGT
TTCCGAGTTTTCGAGATAC -> TCCGAGTTTTCGAGATACA
TTCCGTCTCCTGTATACGC -> TCCGTCTCCTGTATACGCC
TTCCTATTTGGACGGCTGT -> TCCTATTTGGACGGCTGTC
TTCCTGTGGGGGCAGCCGA -> TCCTGTGGGGGCAGCCGAC
TTCGAGATACAGGTCTCTG -> TCGAGATACAGGTCTCTGG
TTCGAGTGGCAAAGGACAT -> TCGAGTGGCAAAGGACATC
TTCGCAGGGATGGGATTTA -> TCGCAGGGATGGGATTTAA
TTCGCCACACTTCCGAGTT -> TCGCCACACTTCCGAGTTT
TTCGGACCGCTATATTTGA -> TCGGACCGCTATATTTGAC
TTCGGTGACTCTCTGGAGG -> TCGGTGACTCTCTGGAGGC
TTCGTCTGGTATTGCTGCC -> TCGTCTGGTATTGCTGCCA
TTCGTTACCAAAAAAATAA -> TCGTTACCAAAAAAATAAC
TTCGTTTGTATCAGGGGAT -> TCGTTTGTATCAGGGGATT
TTCTTACCTGGCTGGGCAT -> TCTTACCTGGCTGGGCATG
TTCTTTATTGGTAAGTCAT -> TCTTTATTGGTAAGTCATA
TTGAACAAGTGACGTCGAA -> TGAACAAGTGACGTCGAAG
TTGAACATATTCATACACC -> TGAACATATTCATACACCG
TTGAACCCCGACTGAAGGG -> TGAACCCCGACTGAAGGGA
TTGAAGACAGGGATAAGCA -> TGAAGACAGGGATAAGCAG
TTGAAGAGTATTTCATAGC -> TGAAGAGTATTTCATAGCT
TTGACCGACAGTTATACCA -> TGACCGACAGTTATACCAG
TTGACCGCGCAGCAGGAGC -> TGACCGCGCAGCAGGAGCT
TTGAGCACATACCGCTCAT -> TGAGCACATACCGCTCATC
TTGAGGATGCACCATGTGG -> TGAGGATGCACCATGTGGG
TTGATAAATCGAGCACCTC -> TGATAAATCGAGCACCTCG
TTGATAAGTTGTCATATTA -> TGATAAGTTGTCATATTAC
TTGATACTTAGGCTGTACG -> TGATACTTAGGCTGTACGG
TTGATCAATCGATACGATG -> TGATCAATCGATACGATGG
TTGCGTTGTCACCTGAATT -> TGCGTTGTCACCTGAATTC
TTGCTGCCATGGCTGTAAC -> TGCTGCCATGGCTGTAACA
TTGGACCAGTTCATGGAAG -> TGGACCAGTTCATGGAAGA
TTGGACCGATGAGTGCAAC -> TGGACCGATGAGTGCAACA
TTGGACGGCTGTCCCCACC -> TGGACGGCTGTCCCCACCT
TTGGATAGGTGAAAGCCGC -> TGGATAGGTGAAAGCCGCA
TTGGGATGGATTGGTGGCT -> TGGGATGGATTGGTGGCTG
TTGGGTTTTAGGTTGTGAG -> TGGGTTTTAGGTTGTGAGT
TTGGTAAGTCATAGAGCTC -> TGGTAAGTCATAGAGCTCC
TTGGTGGCTGGCCTCTCTG -> TGGTGGCTGGCCTCTCTGC
TTGTACCCGACGGATTAGC -> TGTACCCGACGGATTAGCC
TTGTATCAGGGGATTAAAA -> TGTATCAGGGGATTAAAAT
TTGTCACCTGAATTCGGTG -> TGTCACCTGAATTCGGTGA
TTGTCATATTACATACAAC -> TGTCATATTACATACAACG
TTGTGAGTGACGCACGTCA -> TGTGAGTGACGCACGTCAG
TTGTGCAATGACCAGAGAA -> TGTGCAATGACCAGAGAAG
TTGTGCACCGTAGCATGTA -> TGTGCACCGTAGCATGTAG
TTGTGCAGGCTGTGACGGA -> TGTGCAGGCTGTGACGGAG
TTGTGCATACGACGACCTA -> TGTGCATACGACGACCTAG
TTGTGGAAGATGTATAACC -> TGTGGAAGATGTATAACCT
TTGTTCAAAATGTACAGCC -> TGTTCAAAATGTACAGCCT
TTGTTCGTTTGTATCAGGG -> TGTTCGTTTGTATCAGGGG
TTGTTCTTTATTGGTAAGT -> TGTTCTTTATTGGTAAGTC
TTGTTTTGTGGAAGATGTA -> TGTTTTGTGGAAGATGTAT
TTTAAACGGGTTACCGACC -> TTAAACGGGTTACCGACCC
TTTAACTCGAATCCCCTTT -> TTAACTCGAATCCCCTTTC
TTTAGAGTCCTACTCTCAA -> TTAGAGTCCTACTCTCAAA
TTTAGGTTGTGAGTGACGC -> TTAGGTTGTGAGTGACGCA
TTTATAATTCGTTACCAAA -> TTATAATTCGTTACCAAAA
TTTATACTGGTGGTTCCTG -> TTATACTGGTGGTTCCTGT
TTTATTGGTAAGTCATAGA -> TTATTGGTAAGTCATAGAG
TTTCAATCCTAGTGACACA -> TTCAATCCTAGTGACACAA
TTTCATAGCTACGATTTGA -> TTCATAGCTACGATTTGAA
TTTCATCTAAGTGCATTGC -> TTCATCTAAGTGCATTGCG
TTTCATGCCGCCTTTCTTA -> TTCATGCCGCCTTTCTTAC
TTTCCGTCTCCTGTATACG -> TTCCGTCTCCTGTATACGC
TTTCCTATTTGGACGGCTG -> TTCCTATTTGGACGGCTGT
TTTCGAGATACAGGTCTCT -> TTCGAGATACAGGTCTCTG
TTTCGAGTGGCAAAGGACA -> TTCGAGTGGCAAAGGACAT
TTTCTTACCTGGCTGGGCA -> TTCTTACCTGGCTGGGCAT
TTTGAACCCCGACTGAAGG -> TTGAACCCCGACTGAAGGG
TTTGAAGACAGGGATAAGC -> TTGAAGACAGGGATAAGCA
TTTGACCGCGCAGCAGGAG -> TTGACCGCGCAGCAGGAGC
TTTGAGCACATACCGCTCA -> TTGAGCACATACCGCTCAT
TTTGATAAGTTGTCATATT -> TTGATAAGTTGTCATATTA
TTTGGACGGCTGTCCCCAC -> TTGGACGGCTGTCCCCACC
TTTGGGTTTTAGGTTGTGA -> TTGGGTTTTAGGTTGTGAG
TTTGTATCAGGGGATTAAA -> TTGTATCAGGGGATTAAAA
TTTGTGGAAGATGTATAAC -> TTGTGGAAGATGTATAACC
TTTGTTCAAAATGTACAGC -> TTGTTCAAAATGTACAGCC
TTTTAACTCGAATCCCCTT -> TTTAACTCGAATCCCCTTT
TTTTAGGTTGTGAGTGACG -> TTTAGGTTGTGAGTGACGC
TTTTATACTGGTGGTTCCT -> TTTATACTGGTGGTTCCTG
TTTTCGAGATACAGGTCTC -> TTTCGAGATACAGGTCTCT
TTTTGATAAGTTGTCATAT -> TTTGATAAGTTGTCATATT
TTTTGGGTTTTAGGTTGTG -> TTTGGGTTTTAGGTTGTGA
TTTTGTGGAAGATGTATAA -> TTTGTGGAAGATGTATAAC
TTTTTGATAAGTTGTCATA -> TTTTGATAAGTTGTCATAT
